[layer]
type=Tile Layer 1
data=
1,1,0,0,0,0,0,1,1,0,21,
1,1,0,0,21,0,0,1,1,0,0,
1,1,0,0,0,0,0,1,1,0,21,
1,1,1,1,1,1,1,1,1,0,0,
21,1,1,1,1,1,1,1,1,0,0,
0,0,0,0,0,0,0,0,0,0,0,
0,0,0,0,0,0,0,0,0,0,0,
0,0,0,0,0,0,0,0,0,0,0,
0,0,0,0,0,0,0,0,0,0,0,
0,0,0,0,0,0,0,0,0,0,0,
0,0,0,0,0,0,0,0,0,0,0.
[layer]
type=Tile Layer 2
data=
31,31,0,0,0,0,0,31,31,0,0,
30,30,0,0,0,0,0,30,30,0,0,
29,29,0,0,0,0,0,29,29,0,0,
23,23,23,23,23,23,23,23,23,0,0,
0,26,26,26,26,26,26,26,26,0,0,
0,0,0,0,0,0,0,0,0,0,0,
0,0,0,0,0,0,0,0,0,0,0,
0,0,0,0,0,0,0,0,0,0,0,
0,0,0,0,0,0,0,0,0,0,0,
0,0,0,0,0,0,0,0,0,0,0,
0,0,0,0,0,0,0,0,0,0,0.