[layer]
type=Tile Layer 1
data=
0,0,0,0,6,1,2,0,0,0,0,
0,0,0,0,2,6,6,0,0,0,0,
0,21,0,1,2,0,3,2,0,0,0,
7,0,0,1,5,2,3,2,0,0,0,
0,0,0,0,2,1,1,0,0,0,0,
0,0,0,0,21,5,21,0,0,0,0,
0,6,1,1,0,0,0,1,3,1,21,
1,3,6,1,1,21,1,1,5,1,1,
1,4,1,1,1,6,0,1,6,1,1,
4,5,1,1,1,1,0,1,1,6,1,
1,1,1,6,0,4,1,1,6,1,1,
24,1,1,1,4,1,4,5,1,1,0,
22,0,2,1,1,2,4,1,4,0,22,
0,0,0,5,2,2,6,1,0,0,0,
0,0,0,0,1,1,3,0,0,0,0,
0,0,1,0,0,23,0,0,6,0,0,
0,0,0,1,0,0,0,6,0,0,0,
0,0,0,0,0,0,0,0,0,0,0,
0,0,0,0,0,0,0,0,0,0,0,
0,0,0,0,0,0,0,0,0,0,0,
0,0,0,0,0,0,0,0,0,0,0.
[layer]
type=Tile Layer 2
data=
0,0,0,0,104,104,104,0,0,0,0,
0,0,0,0,113,113,113,0,0,0,0,
0,0,0,113,113,0,113,113,0,0,0,
0,0,0,168,168,168,168,168,0,0,0,
0,0,0,0,103,103,103,0,0,0,0,
0,0,0,0,0,103,0,0,0,0,0,
0,101,101,101,0,0,0,101,101,101,0,
83,83,83,83,83,0,83,83,83,83,83,
82,82,82,82,82,82,0,82,82,82,82,
82,82,82,82,82,82,0,82,82,82,82,
74,74,74,74,0,74,74,74,74,74,74,
0,123,123,123,123,123,123,123,123,123,0,
0,0,82,82,82,82,82,82,82,0,0,
0,0,0,80,80,80,80,80,0,0,0,
0,0,0,0,80,80,80,0,0,0,0,
0,0,80,0,0,0,0,0,80,0,0,
0,0,0,80,0,0,0,80,0,0,0,
0,0,0,0,0,0,0,0,0,0,0,
0,0,0,0,0,0,0,0,0,0,0,
0,0,0,0,0,0,0,0,0,0,0,
0,0,0,0,0,0,0,0,0,0,0.