[layer]
type=Tile Layer 1
data=
1,17,0,17,0,17,0,1,1,17,1,
0,18,16,16,1,2,2,18,16,2,1,
0,2,2,2,1,1,2,1,0,1,0,
18,1,1,2,16,18,1,0,18,1,1,
17,19,19,2,1,19,1,1,0,2,1,
0,0,0,16,1,16,0,24,0,1,21,
17,0,19,19,17,1,17,1,2,2,1,
0,18,0,18,21,7,0,0,0,18,0,
0,1,21,19,24,1,17,2,0,19,0,
0,7,0,2,0,0,0,1,1,2,21,
1,1,17,17,1,17,21,17,1,17,1,
1,1,1,1,16,16,16,0,16,1,1,
21,17,7,19,0,2,1,19,1,1,0,
0,7,0,2,0,21,0,0,0,2,0,
7,17,17,17,1,1,1,1,21,17,0,
0,18,0,0,0,0,21,0,0,18,0,
0,2,21,2,0,0,0,0,0,0,0,
1,16,24,18,21,2,16,18,1,2,1,
0,17,0,17,0,0,0,17,1,21,0,
0,16,0,1,2,2,21,18,18,16,1,
7,0,0,2,17,19,0,0,21,0,0,
1,1,16,1,21,18,2,16,2,18,7,
0,24,1,19,0,0,0,0,19,19,0,
18,1,2,18,21,1,7,16,18,18,1,
0,0,0,19,0,19,0,1,0,21,0,
0,2,21,18,0,16,0,18,0,18,1,
0,17,0,0,0,2,21,19,0,0,0,
0,2,16,2,2,16,21,1,18,16,0,
21,1,0,0,2,1,0,0,0,2,0,
16,16,21,2,18,2,1,1,0,18,1,
21,1,19,1,19,1,19,19,1,1,1,
1,16,1,18,1,18,18,18,0,1,1,
17,19,17,1,1,2,2,17,1,2,21,
1,1,16,1,16,1,16,1,0,16,21,
0,0,0,0,0,19,0,0,0,19,21,
1,1,1,1,0,1,0,1,1,1,21,
0,0,2,1,0,0,21,2,1,2,0,
21,1,1,1,1,1,1,1,1,1,1,
21,1,1,1,1,1,1,1,1,1,1,
0,1,1,1,1,1,1,1,1,1,1,
0,2,0,0,0,0,0,1,2,0,21,
1,1,21,1,1,1,7,1,1,1,0,
0,0,0,0,2,2,21,0,0,1,0,
1,1,1,1,1,1,1,1,0,1,21,
0,0,0,1,0,21,0,0,0,1,0,
16,16,0,16,16,1,1,1,1,16,1,
0,17,0,17,0,0,24,0,21,17,0,
21,1,0,1,1,1,1,1,0,1,0,
7,0,0,1,21,0,0,1,0,0,0,
1,1,21,1,0,1,0,1,1,1,1,
0,0,0,1,0,1,0,1,21,0,0,
21,1,1,1,0,1,0,1,0,1,1,
0,0,0,0,0,2,0,2,21,0,0,
16,1,2,16,18,2,21,18,16,2,1,
21,0,0,17,0,0,0,17,0,0,0,
1,1,21,1,0,1,1,1,0,1,1,
0,0,0,1,0,0,0,0,21,1,0,
1,1,21,1,1,1,1,1,1,1,1,
0,17,0,0,0,0,0,17,0,0,0,
1,1,1,1,1,1,1,0,1,1,1,
0,1,21,0,0,1,0,0,0,1,0,
2,2,21,1,0,1,2,1,1,2,0,
1,1,1,1,1,1,1,1,1,1,21,
1,1,21,1,1,1,1,1,1,1,1,
0,0,21,2,7,2,0,0,0,0,0,
21,1,1,1,0,1,0,1,1,1,1,
0,0,0,0,0,0,0,0,0,0,0,
0,0,0,0,0,0,0,0,0,0,0,
0,0,0,0,0,0,0,0,0,0,0,
0,0,0,0,0,0,0,0,0,0,0.
[layer]
type=Tile Layer 2
data=
167,83,0,83,0,83,0,167,167,83,167,
0,167,83,83,167,167,167,167,83,167,167,
0,181,181,181,181,181,181,181,0,181,0,
181,181,181,181,90,181,181,0,181,181,181,
90,181,181,181,181,181,181,181,0,181,181,
0,0,0,125,250,125,0,0,0,250,0,
83,0,166,166,83,166,83,166,166,166,166,
0,249,0,249,0,0,0,0,0,249,0,
0,268,0,268,0,268,134,268,0,268,0,
0,0,0,267,0,0,0,267,267,267,0,
176,176,88,88,176,88,0,88,176,88,176,
161,161,161,161,80,80,80,0,80,161,161,
0,120,0,241,0,241,241,241,241,241,0,
0,0,0,240,0,0,0,0,0,240,0,
0,129,129,129,259,259,259,259,0,129,0,
0,172,0,0,0,0,0,0,0,172,0,
0,170,0,170,0,0,0,0,0,0,0,
234,117,0,234,0,234,117,234,234,234,234,
0,77,0,77,0,0,0,77,155,0,0,
0,77,0,154,154,154,0,154,154,77,154,
0,0,0,249,124,249,0,0,0,0,0,
246,246,123,246,0,246,246,123,246,246,0,
0,0,244,244,0,0,0,0,244,244,0,
225,225,225,225,0,225,0,112,225,225,225,
0,0,0,149,0,149,0,149,0,0,0,
0,148,0,148,0,74,0,148,0,148,148,
0,80,0,0,0,160,0,160,0,0,0,
0,158,79,158,158,79,0,158,158,79,0,
0,157,0,0,157,157,0,0,0,157,0,
72,72,0,144,144,144,144,144,0,144,144,
0,143,143,143,143,143,143,143,143,143,143,
142,71,142,142,142,142,142,142,0,142,142,
77,154,77,154,154,154,154,77,154,154,0,
152,152,76,152,76,152,76,152,0,76,0,
0,0,0,0,0,151,0,0,0,151,0,
138,138,138,138,0,138,0,138,138,138,0,
0,0,137,137,0,0,0,137,137,137,0,
0,136,136,136,136,136,136,136,136,136,136,
0,146,146,146,146,146,146,146,146,146,146,
0,145,145,145,145,145,145,145,145,145,145,
0,145,0,0,0,0,0,145,145,0,0,
199,199,0,199,199,199,0,199,199,199,0,
0,0,0,0,132,132,0,0,0,132,0,
131,131,131,131,131,131,131,131,0,131,0,
0,0,0,140,0,0,0,0,0,140,0,
69,69,0,69,69,139,139,139,139,69,139,
0,104,0,104,0,0,0,0,0,104,0,
0,127,0,127,127,127,127,127,0,127,0,
0,0,0,189,0,0,0,189,0,0,0,
125,125,0,125,0,125,0,125,125,125,125,
0,0,0,134,0,134,0,134,0,0,0,
0,133,133,133,0,133,0,133,0,133,133,
0,0,0,0,0,132,0,132,0,0,0,
60,121,121,60,121,121,0,121,60,121,121,
0,0,0,60,0,0,0,60,0,0,0,
118,118,0,118,0,118,118,118,0,118,118,
0,0,0,108,0,0,0,0,0,108,0,
107,107,0,107,107,107,107,107,107,107,107,
0,53,0,0,0,0,0,53,0,0,0,
96,96,96,96,96,96,96,0,96,96,96,
0,96,0,0,0,96,0,0,0,96,0,
95,95,0,95,0,95,95,95,95,95,0,
94,94,94,94,94,94,94,94,94,94,0,
93,93,0,93,93,93,93,93,93,93,93,
0,0,0,138,0,138,0,0,0,0,0,
0,91,91,91,0,91,0,91,91,91,91,
0,0,0,0,0,0,0,0,0,0,0,
0,0,0,0,0,0,0,0,0,0,0,
0,0,0,0,0,0,0,0,0,0,0,
0,0,0,0,0,0,0,0,0,0,0.