[layer]
type=Tile Layer 1
data=
2,1,2,1,2,0,2,2,1,1,1,
0,7,0,0,0,0,2,2,2,1,1,
2,2,2,2,4,1,1,2,1,2,0,
1,2,2,1,2,0,2,3,1,2,0,
4,1,5,1,0,1,1,6,1,1,1,
1,1,1,4,1,0,1,1,1,4,1,
2,2,1,5,0,2,1,2,2,2,1,
2,2,2,2,1,2,1,0,1,2,1,
0,1,2,2,2,21,2,1,2,3,1,
1,2,2,3,1,21,2,2,1,2,7,
2,2,2,2,2,0,8,0,0,21,0,
0,2,2,2,2,0,21,0,0,24,0,
0,8,21,0,0,0,1,1,3,1,0,
0,0,0,0,21,7,2,2,1,2,1,
21,3,1,1,1,24,4,1,5,1,1,
5,2,2,2,6,7,2,1,1,2,21,
2,2,2,2,2,0,0,0,24,0,0,
0,2,2,2,2,7,21,0,0,0,0,
2,0,2,3,0,2,2,21,6,1,0,
2,2,0,1,2,21,2,2,0,1,1,
0,1,2,0,2,2,7,2,4,21,1,
8,5,0,2,2,0,2,2,21,1,1,
0,0,2,2,21,1,2,8,1,2,0,
0,6,1,21,2,2,0,2,2,0,1,
21,2,0,2,2,0,1,1,0,2,1,
0,21,6,2,0,2,1,8,2,2,0,
0,2,2,21,1,2,0,3,2,8,1,
0,2,0,2,1,7,2,2,21,1,1,
0,21,2,2,0,1,2,0,2,1,0,
1,1,5,1,1,5,3,1,0,1,1,
2,2,7,1,2,21,2,2,0,1,1,
2,2,2,2,7,1,0,2,1,6,21,
1,2,2,21,1,2,1,0,1,2,0,
1,1,0,6,1,1,4,1,21,1,0,
4,21,2,1,2,24,2,1,2,0,0,
21,2,1,1,0,2,0,2,1,2,0,
0,2,2,21,2,1,4,0,2,6,1,
0,1,5,1,1,6,1,1,1,1,1,
7,0,3,3,1,0,1,1,1,21,1,
0,1,1,1,0,1,21,6,6,1,0,
0,0,1,1,21,1,4,8,4,1,0,
21,2,2,8,1,2,0,2,1,0,1,
2,1,0,2,2,21,2,2,0,3,1,
3,21,1,1,0,1,1,7,5,1,0,
1,1,0,6,1,0,1,1,0,6,0,
0,1,6,0,6,1,21,1,1,0,0,
1,21,1,5,0,1,1,0,1,4,0,
4,1,0,1,5,0,1,1,0,1,21,
0,1,1,0,1,1,0,4,3,21,0,
4,0,1,1,21,4,1,0,1,1,0,
1,5,0,2,2,0,2,2,0,1,0,
0,5,1,21,1,1,0,5,1,24,0,
1,0,1,6,21,1,1,0,1,4,0,
1,1,0,6,1,21,1,1,0,4,1,
21,3,1,0,1,5,0,1,1,0,1,
0,3,0,1,1,21,1,1,0,3,1,
0,0,1,1,21,4,3,0,1,1,0,
21,1,1,0,4,1,24,6,1,0,1,
21,1,0,4,1,0,1,1,0,3,1,
24,21,1,5,0,5,1,0,1,1,0,
21,1,3,0,1,1,0,1,3,0,1,
21,2,0,2,2,0,2,1,0,1,1,
0,0,6,5,0,1,1,0,1,1,21,
0,4,6,0,1,1,21,1,1,0,1,
1,4,0,5,1,21,1,1,0,1,1,
1,8,1,1,21,5,4,0,1,1,0,
5,6,0,1,1,21,1,1,24,1,0,
0,1,1,21,5,1,8,5,1,0,0,
2,21,1,1,0,2,2,0,6,2,0,
3,2,0,2,1,21,1,2,0,2,0,
21,2,2,0,2,1,0,2,1,0,0,
1,0,1,1,0,1,4,21,4,1,0,
1,1,0,1,1,21,5,3,0,1,0,
0,1,1,0,1,1,21,6,3,7,0,
1,0,1,4,21,1,5,0,1,1,0,
5,1,0,1,4,0,1,1,0,1,21,
0,0,0,0,0,21,0,0,0,0,0,
0,0,0,0,0,0,0,0,0,0,0,
0,0,0,0,0,0,0,0,0,0,0,
0,0,0,0,0,0,0,0,0,0,0.
[layer]
type=Tile Layer 2
data=
206,206,206,206,206,0,206,206,206,206,206,
0,0,0,0,0,0,309,309,309,309,309,
206,206,206,206,206,206,206,206,206,206,0,
190,190,190,190,190,0,190,190,190,190,0,
190,190,190,190,0,190,190,190,190,190,190,
190,190,190,190,190,0,190,190,190,190,190,
206,206,206,206,0,206,206,206,206,206,206,
206,206,206,206,206,206,206,0,206,206,206,
0,206,206,206,206,0,206,206,206,206,206,
283,283,283,283,283,0,283,283,283,283,0,
282,282,282,282,282,0,0,0,0,0,0,
0,280,280,280,280,0,0,0,0,0,0,
0,0,0,0,0,0,303,303,303,303,0,
0,0,0,0,0,0,300,300,300,300,300,
0,298,298,298,298,0,298,298,298,298,298,
273,273,273,273,273,0,273,273,273,273,0,
271,271,271,271,271,0,0,0,0,0,0,
0,271,271,271,271,0,0,0,0,0,0,
196,0,196,196,0,196,196,0,196,196,0,
194,194,0,194,194,0,194,194,0,194,194,
0,289,289,0,289,289,0,289,289,0,289,
0,265,0,265,265,0,265,265,0,265,265,
0,0,264,264,0,264,264,0,264,264,0,
0,175,175,0,175,175,0,175,175,0,175,
0,188,0,188,188,0,188,188,0,188,188,
0,0,280,280,0,280,280,0,280,280,0,
0,279,279,0,279,279,0,279,279,0,279,
0,255,0,255,255,0,255,255,0,255,255,
0,0,169,169,0,169,169,0,169,169,0,
168,168,168,168,168,168,168,168,0,168,168,
273,273,0,273,273,0,273,273,0,273,273,
271,271,271,271,0,271,0,271,271,271,0,
180,180,180,0,180,180,180,0,180,180,0,
165,165,0,165,165,165,165,165,0,165,0,
246,0,246,246,246,0,246,246,246,0,0,
0,162,162,162,0,162,0,162,162,162,0,
0,175,175,0,175,175,175,0,175,175,175,
0,174,174,174,174,174,174,174,174,174,174,
0,0,261,261,261,0,261,261,261,0,261,
0,159,159,159,0,159,0,159,159,159,0,
0,0,237,237,0,237,237,0,237,237,0,
0,235,235,0,235,235,0,235,235,0,235,
169,169,0,169,169,0,169,169,0,169,169,
252,0,252,252,0,252,252,0,252,252,0,
167,167,0,167,167,0,167,167,0,167,0,
0,154,154,0,154,154,0,154,154,0,0,
153,0,153,153,0,153,153,0,153,153,0,
151,151,0,151,151,0,151,151,0,151,0,
0,163,163,0,163,163,0,163,163,0,0,
162,0,162,162,0,162,162,0,162,162,0,
161,161,0,161,161,0,161,161,0,161,0,
0,222,222,0,222,222,0,222,222,0,0,
147,0,147,147,0,147,147,0,147,147,0,
146,146,0,146,146,0,146,146,0,146,146,
0,157,157,0,157,157,0,157,157,0,157,
0,156,0,156,156,0,156,156,0,156,156,
0,0,155,155,0,155,155,0,155,155,0,
0,213,213,0,213,213,0,213,213,0,213,
0,140,0,140,140,0,140,140,0,140,140,
0,0,208,208,0,208,208,0,208,208,0,
0,150,150,0,150,150,0,150,150,0,150,
0,149,0,149,149,0,149,149,0,149,149,
0,0,148,148,0,148,148,0,148,148,0,
0,135,135,0,135,135,0,135,135,0,135,
134,134,0,134,134,0,134,134,0,134,134,
199,0,199,199,0,199,199,0,199,199,0,
181,181,0,181,181,0,181,181,0,181,0,
0,180,180,0,180,180,0,180,180,0,0,
119,0,119,119,0,119,119,0,119,119,0,
107,107,0,107,107,0,107,107,0,107,0,
0,106,106,0,106,106,0,106,106,0,0,
105,0,105,105,0,105,105,0,105,105,0,
104,104,0,104,104,0,104,104,0,104,0,
0,154,154,0,154,154,0,154,154,0,0,
102,0,102,102,0,102,102,0,102,102,0,
101,101,0,101,101,0,101,101,0,101,0,
0,0,0,0,0,0,0,0,0,0,0,
0,0,0,0,0,0,0,0,0,0,0,
0,0,0,0,0,0,0,0,0,0,0,
0,0,0,0,0,0,0,0,0,0,0.