[layer]
type=Tile Layer 1
data=
2,1,2,1,2,2,2,2,1,1,0,
1,2,2,2,2,0,24,0,2,2,1,
2,2,1,1,1,2,2,21,2,2,1,
2,2,2,2,2,2,1,21,24,1,1,
2,2,2,1,2,2,0,0,0,2,1,
1,2,2,1,0,1,2,2,1,2,1,
2,1,2,1,2,1,2,0,1,2,1,
1,2,2,2,1,2,2,1,8,0,0,
2,2,2,2,21,0,0,0,0,0,0,
1,1,1,1,1,1,0,1,1,1,1,
2,1,2,2,1,2,1,2,21,2,1,
2,1,2,2,2,2,1,2,21,1,1,
2,2,2,2,2,21,8,1,1,2,1,
2,2,2,1,2,2,0,8,21,0,0,
2,2,1,1,2,2,2,1,8,21,0,
2,2,2,2,2,21,0,0,8,2,1,
2,2,1,1,2,21,2,1,2,2,1,
2,2,2,2,2,8,21,1,2,1,1,
2,2,2,1,1,21,8,2,2,2,1,
1,1,1,1,1,7,0,0,21,1,1,
2,2,1,2,1,2,2,2,8,21,1,
2,1,1,2,2,2,1,1,2,8,21,
1,1,1,1,1,1,1,1,1,8,21,
1,2,2,1,1,2,2,2,2,21,1,
1,1,1,21,1,1,1,1,1,1,1,
1,1,1,8,21,1,1,1,1,1,1,
1,2,0,1,2,2,2,1,2,1,1,
1,1,2,2,2,1,2,2,1,2,0,
1,2,2,21,2,1,1,1,2,2,1,
2,1,2,21,2,2,1,1,2,1,1,
2,2,2,21,0,0,1,2,1,2,1,
2,2,1,2,2,21,0,2,1,2,1,
2,1,1,2,2,2,21,0,2,2,1,
2,2,2,1,2,2,2,21,0,0,1,
2,2,1,2,1,1,2,2,2,21,1,
2,2,2,0,21,2,1,1,1,2,1,
2,1,2,8,21,2,1,2,1,2,1,
2,0,7,0,1,1,2,1,2,2,1,
0,21,1,1,1,1,1,1,1,1,1,
21,1,1,1,1,1,1,1,1,1,1,
0,21,1,1,1,1,1,1,1,1,1,
2,21,0,0,2,1,2,1,2,1,1,
0,0,0,21,1,1,1,1,1,1,1,
21,1,1,2,1,2,2,2,2,1,1,
1,1,0,0,21,1,1,1,1,1,1,
2,2,2,2,21,0,0,1,2,2,1,
1,1,1,1,1,1,21,0,0,0,1,
1,1,1,1,1,1,1,1,1,21,0,
1,1,1,1,1,1,1,1,1,1,21,
1,1,1,1,1,1,1,1,1,1,21,
1,1,1,1,1,1,1,1,1,1,21,
1,1,1,1,1,1,8,21,0,0,0,
1,1,1,1,1,1,0,21,0,1,1,
1,1,1,1,1,1,1,21,0,1,1,
1,1,1,1,1,1,1,21,1,1,1,
1,1,1,1,1,1,1,1,0,0,21,
1,1,1,1,1,1,1,1,0,21,1,
1,1,1,1,1,1,1,1,21,0,1,
1,1,1,1,1,1,1,1,0,21,1,
1,1,1,1,1,1,1,1,1,0,21,
1,1,1,1,1,1,1,1,1,1,0,
1,1,1,1,1,1,1,1,1,21,0,
1,1,1,1,1,1,1,1,1,21,0,
2,2,2,1,2,1,1,1,1,2,21,
1,1,1,1,1,1,1,1,1,0,21,
1,1,1,1,1,1,1,1,1,0,21,
1,1,1,1,1,1,1,1,1,0,21,
1,1,1,1,1,1,1,1,1,21,8,
1,2,1,1,2,2,1,2,1,2,21,
1,1,1,1,1,21,0,1,1,1,1,
1,1,1,1,1,1,21,0,0,0,0,
0,0,0,0,0,0,0,0,0,0,0,
0,0,0,0,0,0,0,0,0,0,0,
0,0,0,0,0,0,0,0,0,0,0,
0,0,0,0,0,0,0,0,0,0,0.
[layer]
type=Tile Layer 2
data=
127,127,127,127,127,127,127,127,127,127,0,
264,264,264,264,264,0,0,0,264,264,264,
138,138,138,138,138,138,138,0,138,138,138,
234,234,234,234,234,234,234,0,0,234,234,
160,160,160,160,160,160,0,0,0,160,160,
125,125,125,125,0,125,125,125,125,125,125,
125,125,125,125,125,125,125,0,125,125,125,
261,261,261,261,261,261,261,261,0,0,0,
193,193,193,193,0,0,0,0,0,0,0,
134,134,134,134,134,134,0,134,134,134,134,
123,123,123,123,123,123,123,123,0,123,123,
123,123,123,123,123,123,123,123,0,123,123,
210,210,210,210,210,0,0,210,210,210,210,
282,282,282,282,282,282,0,0,0,0,0,
252,252,252,252,252,252,252,252,0,0,0,
279,279,279,279,279,0,0,0,0,279,279,
119,119,119,119,119,0,119,119,119,119,119,
204,204,204,204,204,0,0,204,204,204,204,
201,201,201,201,201,0,0,201,201,201,201,
271,271,271,271,271,0,0,0,0,271,271,
216,216,216,216,216,216,216,216,0,0,216,
214,214,214,214,214,214,214,214,214,0,0,
196,196,196,196,196,196,196,196,196,0,0,
114,114,114,114,114,114,114,114,114,0,114,
114,114,114,0,114,114,114,114,114,114,114,
208,208,208,0,0,208,208,208,208,208,208,
121,121,0,121,121,121,121,121,121,121,121,
121,121,121,121,121,121,121,121,121,121,0,
111,111,111,0,111,111,111,111,111,111,111,
111,111,111,0,111,111,111,111,111,111,111,
141,141,141,0,0,0,141,141,141,141,141,
136,136,136,136,136,0,0,136,136,136,136,
134,134,134,134,134,134,0,0,134,134,134,
150,150,150,150,150,150,150,0,0,0,150,
107,107,107,107,107,107,107,107,107,0,107,
121,121,121,0,0,121,121,121,121,121,121,
180,180,180,0,0,180,180,180,180,180,180,
217,0,0,0,217,217,217,217,217,217,217,
0,0,130,130,130,130,130,130,130,130,130,
0,113,113,113,113,113,113,113,113,113,113,
0,0,118,118,118,118,118,118,118,118,118,
131,0,0,0,131,131,131,131,131,131,131,
0,0,0,0,144,144,144,144,144,144,144,
0,109,109,109,109,109,109,109,109,109,109,
139,139,0,0,0,139,139,139,139,139,139,
138,138,138,138,0,0,0,138,138,138,138,
140,140,140,140,140,140,0,0,0,0,140,
111,111,111,111,111,111,111,111,111,0,0,
97,97,97,97,97,97,97,97,97,97,0,
104,104,104,104,104,104,104,104,104,104,0,
104,104,104,104,104,104,104,104,104,104,0,
219,219,219,219,219,219,0,0,0,0,0,
120,120,120,120,120,120,0,0,0,120,120,
106,106,106,106,106,106,106,0,0,106,106,
93,93,93,93,93,93,93,0,93,93,93,
127,127,127,127,127,127,127,127,0,0,0,
113,113,113,113,113,113,113,113,0,0,113,
112,112,112,112,112,112,112,112,0,0,112,
101,101,101,101,101,101,101,101,0,0,101,
100,100,100,100,100,100,100,100,100,0,0,
88,88,88,88,88,88,88,88,88,88,0,
92,92,92,92,92,92,92,92,92,0,0,
91,91,91,91,91,91,91,91,91,0,0,
79,79,79,79,79,79,79,79,79,79,0,
80,80,80,80,80,80,80,80,80,0,0,
79,79,79,79,79,79,79,79,79,0,0,
79,79,79,79,79,79,79,79,79,0,0,
117,117,117,117,117,117,117,117,117,0,0,
68,68,68,68,68,68,68,68,68,68,0,
76,76,76,76,76,0,0,76,76,76,76,
94,94,94,94,94,94,0,0,0,0,0,
0,0,0,0,0,0,0,0,0,0,0,
0,0,0,0,0,0,0,0,0,0,0,
0,0,0,0,0,0,0,0,0,0,0,
0,0,0,0,0,0,0,0,0,0,0.