[layer]
type=Tile Layer 1
data=
0,2,2,2,2,1,1,1,1,1,1,
0,2,0,2,0,24,0,21,0,2,0,
2,2,0,1,0,1,2,1,24,2,0,
1,1,1,1,0,1,1,1,1,1,1,
0,2,0,2,1,2,0,1,1,2,1,
2,2,2,1,2,2,0,1,1,1,1,
1,2,2,1,24,1,1,1,2,2,0,
0,0,21,2,0,8,1,2,0,0,0,
2,2,8,2,0,1,1,2,21,1,1,
0,0,0,21,0,1,0,24,0,1,0,
21,1,1,1,1,1,0,1,1,1,1,
21,1,0,0,0,2,0,2,0,0,0,
2,2,0,1,0,2,0,1,0,2,21,
21,0,0,1,0,2,0,7,0,2,0,
2,1,2,1,0,1,1,1,2,2,21,
0,2,2,2,8,0,0,21,0,0,0,
7,1,21,2,2,2,2,1,1,1,1,
21,2,0,0,0,0,0,0,2,1,0,
7,2,2,2,21,1,2,1,1,1,0,
1,2,1,2,2,1,1,2,0,2,1,
1,1,21,1,0,1,0,1,0,1,1,
21,1,0,1,0,1,0,1,0,0,0,
0,1,8,2,2,2,21,0,0,0,0,
1,2,0,1,2,1,21,1,2,2,0,
0,0,0,1,0,0,21,1,1,0,0,
2,1,2,2,7,1,21,1,2,2,1,
0,0,0,0,0,2,2,1,0,0,21,
2,2,1,1,0,2,1,2,21,2,1,
0,21,0,2,0,0,0,0,0,2,0,
1,1,21,1,1,1,1,1,1,1,7,
0,0,0,0,0,21,0,1,1,1,0,
1,2,2,2,2,1,21,2,8,1,1,
0,0,0,1,0,21,0,1,8,0,0,
0,1,0,1,21,1,1,1,1,1,1,
0,1,0,0,0,0,0,21,0,1,0,
0,2,2,1,1,1,2,1,21,2,0,
0,0,1,1,0,21,0,1,0,0,0,
1,1,1,1,0,1,21,1,1,1,1,
21,1,1,1,1,1,1,1,1,1,1,
1,1,1,1,1,1,21,1,1,1,1,
1,1,1,1,1,1,1,0,1,1,1,
1,1,1,1,1,1,1,1,1,0,1,
0,1,1,1,1,1,21,1,0,1,1,
21,1,0,0,1,2,0,0,0,2,0,
1,1,0,1,1,1,1,1,1,1,21,
1,1,0,1,0,1,21,1,1,1,0,
0,2,0,0,0,2,21,0,0,1,0,
21,1,1,1,1,1,1,1,0,1,1,
21,7,0,0,0,1,1,1,0,0,0,
2,2,1,2,0,2,0,1,1,1,21,
21,1,0,0,0,1,0,0,0,1,0,
0,1,0,1,1,1,1,1,21,1,1,
21,1,1,1,1,1,0,1,1,1,1,
1,1,0,1,1,1,1,1,1,1,1,
1,1,0,1,1,1,1,1,0,1,1,
0,21,8,1,0,0,0,0,0,1,0,
2,1,1,2,0,2,1,1,1,2,21,
0,1,0,21,0,1,1,0,8,1,0,
0,1,21,1,1,1,1,1,0,1,1,
0,0,0,0,21,1,1,1,0,0,0,
0,1,1,1,1,1,21,1,0,1,0,
0,0,0,0,0,0,0,0,0,0,0,
0,0,0,0,0,0,0,0,0,0,0,
0,0,0,0,0,0,0,0,0,0,0,
0,0,0,0,0,0,0,0,0,0,0.
[layer]
type=Tile Layer 2
data=
0,147,147,147,147,147,147,147,147,147,147,
0,244,0,244,0,0,0,0,0,244,0,
241,241,0,241,0,241,241,241,0,241,0,
159,159,159,159,0,159,159,159,159,159,159,
0,175,0,175,175,175,0,175,175,175,175,
159,159,159,159,159,159,0,159,159,159,159,
241,241,241,241,0,241,241,241,241,241,0,
0,0,0,241,0,0,241,241,0,0,0,
240,240,0,240,0,240,240,240,0,240,240,
0,0,0,0,0,259,0,0,0,259,0,
0,172,172,172,172,172,0,172,172,172,172,
0,171,0,0,0,171,0,171,0,0,0,
156,156,0,156,0,156,0,156,0,156,0,
0,0,0,232,0,232,0,0,0,232,0,
154,154,154,154,0,154,154,154,154,154,0,
0,249,249,249,0,0,0,0,0,0,0,
0,247,0,247,247,247,247,247,247,247,247,
0,163,0,0,0,0,0,0,163,163,0,
0,223,223,223,0,223,223,223,223,223,0,
134,134,134,134,134,134,134,134,0,134,134,
148,148,0,148,0,148,0,148,0,148,148,
0,160,0,160,0,160,0,160,0,0,0,
0,238,0,238,238,238,0,0,0,0,0,
157,157,0,157,157,157,0,157,157,157,0,
0,0,0,144,0,0,0,144,144,0,0,
214,214,214,214,0,214,0,214,214,214,214,
0,0,0,0,0,142,142,142,0,0,0,
153,153,153,153,0,153,153,153,0,153,153,
0,0,0,151,0,0,0,0,0,151,0,
225,225,0,225,225,225,225,225,225,225,0,
0,0,0,0,0,0,0,137,137,137,0,
204,204,204,204,204,204,0,204,0,204,204,
0,0,0,202,0,0,0,202,0,0,0,
0,145,0,145,0,145,145,145,145,145,145,
0,144,0,0,0,0,0,0,0,144,0,
0,143,143,143,143,143,143,143,0,143,0,
0,0,131,131,0,0,0,131,0,0,0,
130,130,130,130,0,130,0,130,130,130,130,
0,116,116,116,116,116,116,116,116,116,116,
125,125,125,125,125,125,0,125,125,125,125,
124,124,124,124,124,124,124,0,124,124,124,
124,124,124,124,124,124,124,124,124,0,124,
0,126,126,126,126,126,0,126,0,126,126,
0,125,0,0,125,125,0,0,0,125,0,
124,124,0,124,124,124,124,124,124,124,0,
133,133,0,133,0,133,0,133,133,133,0,
0,132,0,0,0,132,0,0,0,132,0,
0,131,131,131,131,131,131,131,0,131,131,
0,0,0,0,0,180,180,180,0,0,0,
119,119,119,119,0,119,0,119,119,119,0,
0,117,0,0,0,117,0,0,0,117,0,
0,107,0,107,107,107,107,107,0,107,107,
0,106,106,106,106,106,0,106,106,106,106,
95,95,0,95,95,95,95,95,95,95,95,
95,95,0,95,95,95,95,95,0,95,95,
0,0,0,142,0,0,0,0,0,142,0,
94,94,94,94,0,94,94,94,94,94,0,
0,139,0,0,0,139,139,0,0,139,0,
0,92,0,92,92,92,92,92,0,92,92,
0,0,0,0,0,91,91,91,0,0,0,
0,90,90,90,90,90,0,90,0,90,0,
0,0,0,0,0,0,0,0,0,0,0,
0,0,0,0,0,0,0,0,0,0,0,
0,0,0,0,0,0,0,0,0,0,0,
0,0,0,0,0,0,0,0,0,0,0.