[layer]
type=Tile Layer 1
data=
1,0,1,0,1,1,1,1,1,0,1,
1,0,1,0,0,0,0,0,0,0,1,
1,1,1,0,1,1,1,1,1,0,1,
1,0,0,0,1,0,1,0,0,0,1,
1,0,1,1,1,0,1,0,1,1,1,
0,0,0,1,0,0,1,0,0,1,0,
0,0,0,0,0,0,0,0,0,0,0,
0,0,0,0,0,0,0,0,0,0,0,
0,0,0,0,0,0,0,0,0,0,0,
0,0,0,0,0,0,0,0,0,0,0,
0,0,0,0,0,0,0,0,0,0,0.
[layer]
type=Tile Layer 2
data=
26,0,26,0,26,26,26,26,26,0,26,
28,0,28,0,0,0,0,0,0,0,28,
23,23,23,0,23,23,23,23,23,0,23,
28,0,0,0,28,0,28,0,0,0,28,
26,0,26,26,26,0,26,0,26,26,26,
0,0,0,28,0,0,28,0,0,28,0,
0,0,0,0,0,0,0,0,0,0,0,
0,0,0,0,0,0,0,0,0,0,0,
0,0,0,0,0,0,0,0,0,0,0,
0,0,0,0,0,0,0,0,0,0,0,
0,0,0,0,0,0,0,0,0,0,0.