[layer]
type=Tile Layer 1
data=
1,1,17,1,0,17,17,17,1,17,1,
1,16,0,16,16,18,2,2,2,2,1,
17,7,1,17,1,17,17,21,1,1,1,
16,18,16,1,2,0,2,18,1,1,1,
19,2,2,0,19,17,17,8,1,0,1,
0,0,21,0,18,0,0,0,18,0,0,
2,17,2,19,19,8,2,17,1,17,1,
16,0,0,0,16,0,16,0,0,0,1,
19,0,17,21,2,0,19,0,19,0,1,
2,21,2,0,0,0,2,7,1,0,0,
17,1,2,19,17,1,2,0,17,19,1,
2,1,1,0,1,2,1,2,2,1,1,
1,2,19,0,19,17,2,1,17,2,1,
0,0,0,0,0,0,2,16,18,0,21,
1,17,17,21,17,1,1,1,1,17,1,
18,18,24,0,18,0,0,0,21,0,0,
19,17,2,19,1,21,17,19,1,2,1,
18,21,0,0,18,0,0,7,0,0,18,
0,1,1,17,1,19,19,2,2,19,1,
18,7,18,0,0,0,21,0,0,0,18,
17,21,17,19,1,2,2,19,1,1,1,
16,0,0,0,16,0,0,0,21,0,0,
1,1,1,21,1,8,1,1,1,1,1,
0,0,0,0,2,0,0,21,2,0,0,
2,19,19,17,2,17,17,21,2,8,1,
24,0,0,0,2,0,0,21,2,0,1,
17,17,1,0,17,21,1,17,1,8,1,
1,2,2,0,0,7,1,2,2,0,21,
17,19,2,19,19,2,17,21,1,8,1,
1,1,1,21,1,1,1,0,1,1,1,
0,0,24,21,17,0,0,0,19,2,1,
16,16,1,16,1,24,1,16,16,21,1,
0,0,0,0,19,0,0,21,0,0,19,
2,16,2,21,2,1,16,16,18,0,1,
21,8,17,0,17,0,0,0,0,0,17,
1,1,1,0,0,0,0,21,0,0,0,
1,0,1,1,1,1,1,1,1,1,1,
1,21,1,1,1,1,1,1,1,1,1,
0,0,0,0,21,1,1,0,0,0,1,
1,1,1,1,1,1,1,21,1,7,1,
0,19,19,8,0,21,0,0,19,0,0,
1,2,1,1,2,2,0,2,2,1,1,
0,0,1,21,0,0,1,0,24,0,0,
1,0,1,1,1,21,1,0,1,1,1,
21,0,0,0,2,0,0,0,2,0,0,
1,1,1,0,1,1,1,1,1,21,1,
17,17,1,0,0,21,1,17,17,0,0,
1,2,2,2,1,21,2,1,1,2,1,
1,1,1,1,1,1,1,1,0,1,1,
1,2,2,1,2,2,1,0,2,0,1,
1,0,7,0,1,1,1,21,0,0,1,
1,7,1,0,16,0,16,1,16,16,1,
1,0,1,0,0,0,1,0,0,21,1,
1,0,1,1,1,21,1,0,1,0,1,
0,1,1,1,1,1,1,1,1,1,1,
1,0,1,21,1,1,1,1,1,0,1,
0,0,2,0,0,0,2,0,0,21,0,
16,1,16,16,1,21,16,0,16,1,1,
2,0,0,2,2,0,2,21,0,0,1,
18,0,18,16,1,21,2,2,16,0,1,
1,8,0,0,0,0,1,21,0,0,1,
1,2,1,2,2,0,1,21,2,2,1,
0,21,0,0,17,0,2,0,2,17,1,
16,1,16,0,16,0,16,21,1,0,1,
0,0,0,0,1,21,0,0,1,0,0,
1,1,1,1,1,1,0,1,1,1,1,
0,0,0,0,0,0,0,0,0,0,0,
0,0,0,0,0,0,0,0,0,0,0,
0,0,0,0,0,0,0,0,0,0,0,
0,0,0,0,0,0,0,0,0,0,0.
[layer]
type=Tile Layer 2
data=
173,173,86,173,0,86,86,86,173,86,173,
173,86,0,86,86,173,173,173,173,173,173,
141,0,282,141,282,141,141,0,282,282,282,
93,187,93,187,187,0,187,187,187,187,187,
280,280,280,0,280,140,140,0,280,0,280,
0,0,0,0,172,0,0,0,172,0,0,
256,128,256,256,256,0,256,128,256,128,256,
85,0,0,0,85,0,85,0,0,0,171,
186,0,93,0,186,0,186,0,186,0,186,
277,0,277,0,0,0,277,0,277,0,0,
92,184,184,184,92,184,184,0,92,184,184,
169,169,169,0,169,169,169,169,169,169,169,
169,169,169,0,169,84,169,169,84,169,169,
0,0,0,0,0,0,169,84,169,0,0,
182,91,91,0,91,182,182,182,182,91,182,
271,271,0,0,271,0,0,0,0,0,0,
180,90,180,180,180,0,90,180,180,180,180,
247,0,0,0,247,0,0,0,0,0,247,
0,164,164,82,164,164,164,164,164,164,164,
246,0,246,0,0,0,0,0,0,0,246,
88,0,88,176,176,176,176,176,176,176,176,
87,0,0,0,87,0,0,0,0,0,0,
261,261,261,0,261,0,261,261,261,261,261,
0,0,0,0,159,0,0,0,159,0,0,
237,237,237,118,237,118,118,0,237,0,237,
0,0,0,0,235,0,0,0,235,0,235,
126,126,253,0,126,0,253,126,253,0,253,
252,252,252,0,0,0,252,252,252,0,0,
125,250,250,250,250,250,125,0,250,0,250,
153,153,153,0,153,153,153,0,153,153,153,
0,0,0,0,113,0,0,0,226,226,226,
112,112,225,112,225,0,225,112,112,0,225,
0,0,0,0,162,0,0,0,0,0,162,
161,80,161,0,161,161,80,80,161,0,161,
0,0,120,0,120,0,0,0,0,0,120,
146,146,146,0,0,0,0,0,0,0,0,
145,0,145,145,145,145,145,145,145,145,145,
145,0,145,145,145,145,145,145,145,145,145,
0,0,0,0,0,156,156,0,0,0,156,
232,232,232,232,232,232,232,0,232,0,232,
0,231,231,0,0,0,0,0,231,0,0,
140,140,140,140,140,140,0,140,140,140,140,
0,0,210,0,0,0,210,0,0,0,0,
139,0,139,139,139,0,139,0,139,139,139,
0,0,0,0,150,0,0,0,150,0,0,
149,149,149,0,149,149,149,149,149,0,149,
74,74,148,0,0,0,148,74,74,0,0,
135,135,135,135,135,0,135,135,135,135,135,
134,134,134,134,134,134,134,134,0,134,134,
134,134,134,134,134,134,134,0,134,0,134,
217,0,0,0,217,217,217,0,0,0,217,
216,0,216,0,108,0,108,216,108,108,216,
144,0,144,0,0,0,144,0,0,0,144,
132,0,132,132,132,0,132,0,132,0,132,
0,131,131,131,131,131,131,131,131,131,131,
131,0,131,0,131,131,131,131,131,0,131,
0,0,119,0,0,0,119,0,0,0,0,
59,118,59,59,118,0,59,0,59,118,118,
117,0,0,117,117,0,117,0,0,0,117,
105,0,105,52,105,0,105,105,52,0,105,
156,0,0,0,0,0,156,0,0,0,156,
103,103,103,103,103,0,103,0,103,103,103,
0,0,0,0,51,0,102,0,102,51,102,
50,101,50,0,50,0,50,0,101,0,101,
0,0,0,0,100,0,0,0,100,0,0,
100,100,100,100,100,100,0,100,100,100,100,
0,0,0,0,0,0,0,0,0,0,0,
0,0,0,0,0,0,0,0,0,0,0,
0,0,0,0,0,0,0,0,0,0,0,
0,0,0,0,0,0,0,0,0,0,0.