[layer]
type=Tile Layer 1
data=
18,16,18,18,2,1,18,0,0,24,1,
17,19,1,2,0,17,2,17,1,2,1,
1,2,18,1,16,2,16,18,21,0,0,
1,19,19,1,17,19,19,2,0,0,1,
16,16,1,16,1,16,1,0,1,16,1,
2,2,1,2,1,2,2,0,1,1,1,
1,0,2,16,1,16,18,18,2,18,1,
2,2,2,2,2,0,0,0,1,1,1,
1,2,1,2,21,7,2,1,2,2,1,
1,1,17,21,24,1,17,17,1,17,1,
1,16,16,21,2,2,18,1,18,1,1,
19,19,19,21,0,0,0,1,17,2,1,
18,0,16,18,1,1,1,18,18,2,1,
2,19,19,19,21,8,17,1,17,2,1,
18,16,18,2,21,0,24,18,16,2,1,
17,17,2,19,19,1,21,19,1,2,1,
16,1,16,16,16,1,21,7,1,16,1,
1,19,19,2,19,19,17,0,7,21,1,
1,16,18,1,2,2,16,16,2,7,21,
2,17,1,1,19,19,1,1,19,21,7,
1,1,1,1,1,1,1,1,1,21,0,
17,1,19,2,2,17,1,2,17,1,21,
16,2,16,2,2,16,2,1,16,0,21,
2,2,1,1,2,1,2,2,8,21,1,
2,18,16,2,18,1,16,16,21,2,1,
1,2,1,0,1,1,1,2,2,2,1,
16,1,21,0,2,18,2,16,18,1,1,
17,2,0,21,1,2,17,19,1,19,1,
2,1,2,21,0,2,1,1,1,2,1,
0,0,0,21,0,1,1,1,1,1,1,
0,0,0,21,0,0,16,18,1,2,1,
17,17,1,1,17,0,21,1,17,17,1,
2,16,2,2,2,16,21,18,16,16,1,
2,2,2,1,2,2,0,0,0,0,1,
16,1,1,16,16,1,16,16,21,0,1,
1,1,17,17,17,1,17,1,21,0,0,
2,18,18,16,16,18,1,2,0,1,1,
1,1,1,1,1,1,1,21,0,1,1,
2,2,1,1,2,2,1,1,24,21,0,
1,1,1,1,1,1,1,1,1,1,21,
1,1,1,1,1,1,1,1,21,0,0,
17,1,17,17,17,1,21,7,0,17,1,
2,1,2,2,2,1,0,0,0,2,1,
1,1,1,1,1,1,1,1,21,1,1,
1,1,1,1,1,1,1,1,24,21,0,
17,19,2,17,1,19,1,2,1,7,21,
2,1,1,1,1,2,2,2,1,21,0,
1,1,1,1,1,1,1,1,1,0,21,
1,1,1,1,1,1,1,1,1,21,0,
1,1,17,17,17,1,1,1,17,1,21,
1,1,1,1,1,1,1,1,1,1,21,
1,2,1,1,2,19,19,17,17,1,21,
2,2,1,2,2,1,1,1,1,1,21,
17,2,19,19,2,19,17,0,21,1,1,
1,1,1,1,1,1,1,1,21,0,0,
17,1,17,17,1,1,17,1,1,1,21,
16,16,1,1,1,1,16,1,16,24,21,
1,1,1,1,1,1,1,1,1,21,1,
16,16,16,1,1,1,16,16,1,21,1,
1,1,1,1,1,1,1,1,1,21,0,
1,1,1,1,1,1,1,1,1,1,21,
19,1,19,2,1,1,1,1,19,17,21,
1,2,2,2,1,1,2,1,1,1,21,
1,1,1,1,1,0,0,21,0,0,0,
16,1,1,16,16,21,1,16,16,1,1,
1,1,1,1,1,21,1,1,1,1,1,
1,1,1,21,1,1,1,1,1,1,1,
1,1,1,21,1,1,1,1,1,1,1,
1,1,1,21,1,1,1,1,1,1,1,
1,1,0,21,1,1,1,1,1,1,1,
1,1,0,21,1,1,1,1,1,1,1,
0,0,0,0,0,0,0,0,0,0,0,
0,0,0,0,0,0,0,0,0,0,0,
0,0,0,0,0,0,0,0,0,0,0,
0,0,0,0,0,0,0,0,0,0,0.
[layer]
type=Tile Layer 2
data=
241,120,241,241,241,241,241,0,0,0,241,
68,137,137,137,0,68,137,68,137,137,137,
175,175,175,175,87,175,87,175,0,0,0,
155,155,155,155,77,155,155,155,0,0,155,
62,62,125,62,125,62,125,0,125,62,125,
125,125,125,125,125,125,125,0,125,125,125,
125,0,125,62,125,62,125,125,125,125,125,
174,174,174,174,174,0,0,0,174,174,174,
232,232,232,232,0,0,232,232,232,232,232,
231,231,115,0,0,231,115,115,231,115,231,
123,61,61,0,123,123,123,123,123,123,123,
174,174,174,0,0,0,0,174,87,174,174,
121,0,60,121,121,121,121,121,121,121,121,
226,226,226,226,0,0,113,226,113,226,226,
252,126,252,252,0,0,0,252,126,252,252,
65,65,131,131,131,131,0,131,131,131,131,
102,204,102,102,102,204,0,0,204,102,204,
228,228,228,228,228,228,114,0,0,0,228,
201,100,201,201,201,201,100,100,201,0,0,
217,108,217,217,217,217,217,217,217,0,0,
144,144,144,144,144,144,144,144,144,0,0,
63,126,126,126,126,63,126,126,63,126,0,
65,131,65,131,131,65,131,131,65,0,0,
195,195,195,195,195,195,195,195,0,0,195,
114,114,57,114,114,114,57,57,0,114,114,
122,122,122,0,122,122,122,122,122,122,122,
69,139,0,0,139,139,139,69,139,139,139,
69,138,0,0,138,138,69,138,138,138,138,
127,127,127,0,0,127,127,127,127,127,127,
0,0,0,0,0,156,156,156,156,156,156,
0,0,0,0,0,0,77,155,155,155,155,
67,67,134,134,67,0,0,134,67,67,134,
118,59,118,118,118,59,0,118,59,59,118,
166,166,166,166,166,166,0,0,0,0,166,
61,122,122,61,61,122,61,61,0,0,122,
136,136,68,68,68,136,68,136,0,0,0,
106,106,106,53,53,106,106,106,0,106,106,
131,131,131,131,131,131,131,0,0,131,131,
217,217,217,217,217,217,217,217,0,0,0,
113,113,113,113,113,113,113,113,113,113,0,
132,132,132,132,132,132,132,132,0,0,0,
98,196,98,98,98,196,0,0,0,98,196,
130,130,130,130,130,130,0,0,0,130,130,
110,110,110,110,110,110,110,110,0,110,110,
210,210,210,210,210,210,210,210,0,0,0,
93,186,186,93,186,186,186,186,186,0,0,
114,114,114,114,114,114,114,114,114,0,0,
112,112,112,112,112,112,112,112,112,0,0,
111,111,111,111,111,111,111,111,111,0,0,
106,106,53,53,53,106,106,106,53,106,0,
104,104,104,104,104,104,104,104,104,104,0,
104,104,104,104,104,104,104,52,52,104,0,
95,95,95,95,95,95,95,95,95,95,0,
53,107,107,107,107,107,53,0,0,107,107,
119,119,119,119,119,119,119,119,0,0,0,
50,101,50,50,101,101,50,101,101,101,0,
85,85,171,171,171,171,85,171,85,0,0,
98,98,98,98,98,98,98,98,98,0,98,
45,45,45,90,90,90,45,45,90,0,90,
101,101,101,101,101,101,101,101,101,0,0,
88,88,88,88,88,88,88,88,88,88,0,
81,81,81,81,81,81,81,81,81,40,0,
80,80,80,80,80,80,80,80,80,80,0,
112,112,112,112,112,0,0,0,0,0,0,
35,70,70,35,35,0,70,35,35,70,70,
70,70,70,70,70,0,70,70,70,70,70,
69,69,69,0,69,69,69,69,69,69,69,
68,68,68,0,68,68,68,68,68,68,68,
68,68,68,0,68,68,68,68,68,68,68,
76,76,0,0,76,76,76,76,76,76,76,
76,76,0,0,76,76,76,76,76,76,76,
0,0,0,0,0,0,0,0,0,0,0,
0,0,0,0,0,0,0,0,0,0,0,
0,0,0,0,0,0,0,0,0,0,0,
0,0,0,0,0,0,0,0,0,0,0.