[layer]
type=Tile Layer 1
data=
1,1,1,1,1,1,0,0,24,0,0,
0,1,2,1,2,1,0,1,2,2,0,
21,1,2,2,1,2,24,0,0,2,0,
21,1,1,1,1,1,1,1,1,1,1,
1,1,2,2,2,2,1,2,1,0,1,
1,1,1,1,1,0,1,1,1,1,1,
24,1,21,2,1,1,2,2,1,2,1,
24,1,0,1,2,1,2,2,21,0,0,
24,1,21,1,1,1,1,1,0,1,1,
1,1,1,1,0,0,0,0,0,1,0,
2,2,21,2,0,24,0,0,0,2,0,
1,1,1,1,1,1,1,1,0,1,21,
1,1,0,1,2,2,2,1,0,2,21,
2,2,1,2,2,1,1,1,2,1,0,
21,0,0,1,2,1,1,1,7,2,0,
0,21,24,1,2,1,1,1,0,2,0,
0,21,24,1,1,2,1,1,1,2,0,
0,1,1,1,1,1,1,1,1,1,1,
1,2,1,1,21,2,1,2,2,1,0,
0,0,0,0,0,1,2,1,1,2,21,
1,1,1,1,2,1,2,2,2,1,21,
1,0,2,2,2,1,2,1,1,2,1,
1,1,2,1,21,2,1,1,2,2,24,
2,2,2,1,21,1,7,2,1,1,0,
1,1,1,1,0,1,21,1,1,1,1,
0,0,21,0,24,2,0,1,2,1,0,
1,2,2,2,1,2,21,1,1,2,1,
8,1,1,1,21,2,1,2,2,2,0,
0,2,0,0,0,1,1,2,21,1,0,
1,2,2,1,21,2,1,2,0,1,0,
21,2,2,1,0,2,1,2,0,1,0,
0,1,1,1,1,1,1,1,21,1,1,
2,1,21,2,1,1,0,2,1,2,1,
1,2,0,2,1,1,21,1,2,2,1,
1,1,2,2,2,1,2,2,1,1,0,
1,1,0,24,0,0,0,0,21,1,1,
21,1,1,2,2,2,1,1,2,1,1,
21,1,1,1,0,1,0,1,1,1,1,
0,1,0,2,0,2,21,2,1,2,1,
0,1,0,1,1,1,21,1,1,1,1,
0,1,0,1,1,1,1,1,1,1,21,
0,1,0,1,21,1,1,1,1,1,0,
0,1,21,1,0,1,1,1,1,1,0,
21,1,1,1,1,1,1,1,0,1,1,
2,1,21,1,2,2,1,2,7,1,1,
1,2,0,0,21,2,1,2,0,2,1,
2,1,24,21,0,2,2,2,0,1,1,
1,1,1,1,1,1,1,1,24,21,0,
1,1,1,1,1,1,1,0,21,8,0,
1,1,1,21,1,1,1,1,1,1,1,
1,1,1,1,1,1,0,1,1,1,1,
1,1,1,0,0,21,1,1,1,1,1,
1,1,1,0,0,0,1,0,0,0,21,
1,1,1,1,1,1,1,21,1,1,1,
1,1,1,1,1,1,1,1,1,21,1,
2,2,2,0,0,0,0,21,2,0,1,
1,1,1,0,1,1,1,24,1,21,1,
0,0,1,0,1,1,1,21,1,0,1,
1,1,1,0,1,1,1,21,1,0,1,
1,1,1,0,1,21,0,0,1,0,1,
1,1,1,21,2,2,1,2,2,1,1,
1,0,0,0,0,0,1,1,1,0,1,
2,0,0,21,0,0,2,1,1,0,0,
1,1,1,1,1,1,1,1,1,21,1,
1,2,2,2,1,0,1,2,2,0,1,
1,1,1,1,1,0,1,1,1,21,1,
0,0,0,0,0,0,0,0,0,0,0,
0,0,0,0,0,0,0,0,0,0,0,
0,0,0,0,0,0,0,0,0,0,0,
0,0,0,0,0,0,0,0,0,0,0.
[layer]
type=Tile Layer 2
data=
259,259,259,259,259,259,0,0,0,0,0,
0,155,155,155,155,155,0,155,155,155,0,
0,282,282,282,282,282,0,0,0,282,0,
0,132,132,132,132,132,132,132,132,132,132,
131,131,131,131,131,131,131,131,131,0,131,
120,120,120,120,120,0,120,120,120,120,120,
0,205,0,205,205,205,205,205,205,205,205,
0,255,0,255,255,255,255,255,0,0,0,
0,249,0,249,249,249,249,249,0,249,249,
182,182,182,182,0,0,0,0,0,182,0,
273,273,0,273,0,0,0,0,0,273,0,
133,133,133,133,133,133,133,133,0,133,0,
149,149,0,149,149,149,149,149,0,149,0,
116,116,116,116,116,116,116,116,116,116,0,
0,0,0,268,268,268,268,268,0,268,0,
0,0,0,267,267,267,267,267,0,267,0,
0,0,0,264,264,264,264,264,264,264,0,
0,114,114,114,114,114,114,114,114,114,114,
129,129,129,129,0,129,129,129,129,129,0,
0,0,0,0,0,160,160,160,160,160,0,
121,121,121,121,121,121,121,121,121,121,0,
121,0,121,121,121,121,121,121,121,121,121,
207,207,207,207,0,207,207,207,207,207,0,
211,211,211,211,0,211,0,211,211,211,0,
125,125,125,125,0,125,0,125,125,125,125,
0,0,0,0,0,231,0,231,231,231,0,
118,118,118,118,118,118,0,118,118,118,118,
0,223,223,223,0,223,223,223,223,223,0,
0,164,0,0,0,164,164,164,0,164,0,
134,134,134,134,0,134,134,134,0,134,0,
0,149,149,149,0,149,149,149,0,149,0,
0,118,118,118,118,118,118,118,0,118,118,
128,128,0,128,128,128,0,128,128,128,128,
127,127,0,127,127,127,0,127,127,127,127,
110,110,110,110,110,110,110,110,110,110,0,
216,216,0,0,0,0,0,0,0,216,216,
0,100,100,100,100,100,100,100,100,100,100,
0,128,128,128,0,128,0,128,128,128,128,
0,154,0,154,0,154,0,154,154,154,154,
0,137,0,137,137,137,0,137,137,137,137,
0,136,0,136,136,136,136,136,136,136,0,
0,138,0,138,0,138,138,138,138,138,0,
0,137,0,137,0,137,137,137,137,137,0,
0,109,109,109,109,109,109,109,0,109,109,
177,177,0,177,177,177,177,177,0,177,177,
145,145,0,0,0,145,145,145,0,145,145,
216,216,0,0,0,216,216,216,0,216,216,
177,177,177,177,177,177,177,177,0,0,0,
195,195,195,195,195,195,195,0,0,0,0,
90,90,90,0,90,90,90,90,90,90,90,
98,98,98,98,98,98,0,98,98,98,98,
125,125,125,0,0,0,125,125,125,125,125,
138,138,138,0,0,0,138,0,0,0,0,
88,88,88,88,88,88,88,0,88,88,88,
88,88,88,88,88,88,88,88,88,0,88,
123,123,123,0,0,0,0,0,123,0,123,
151,151,151,0,151,151,151,0,151,0,151,
0,0,111,0,111,111,111,0,111,0,111,
99,99,99,0,99,99,99,0,99,0,99,
98,98,98,0,98,0,0,0,98,0,98,
68,68,68,0,68,68,68,68,68,68,68,
96,0,0,0,0,0,96,96,96,0,96,
96,0,0,0,0,0,96,96,96,0,0,
67,67,67,67,67,67,67,67,67,0,67,
76,76,76,76,76,0,76,76,76,0,76,
76,76,76,76,76,0,76,76,76,0,76,
0,0,0,0,0,0,0,0,0,0,0,
0,0,0,0,0,0,0,0,0,0,0,
0,0,0,0,0,0,0,0,0,0,0,
0,0,0,0,0,0,0,0,0,0,0.