[layer]
type=Tile Layer 1
data=
0,1,1,1,0,0,0,1,1,1,0,
0,1,0,0,0,0,0,0,0,1,0,
0,1,1,1,0,0,0,1,1,1,0,
0,0,0,1,1,1,1,1,0,0,0,
0,0,0,0,0,0,0,0,0,0,0,
0,0,0,0,0,0,0,0,0,0,0,
0,0,0,0,0,0,0,0,0,0,0,
0,0,0,0,0,0,0,0,0,0,0,
0,0,0,0,0,0,0,0,0,0,0,
0,0,0,0,0,0,0,0,0,0,0,
0,0,0,0,0,0,0,0,0,0,0.
[layer]
type=Tile Layer 2
data=
0,28,28,28,0,0,0,28,28,28,0,
0,28,0,0,0,0,0,0,0,28,0,
0,28,28,28,0,0,0,28,28,28,0,
0,0,0,28,28,28,28,28,0,0,0,
0,0,0,0,0,0,0,0,0,0,0,
0,0,0,0,0,0,0,0,0,0,0,
0,0,0,0,0,0,0,0,0,0,0,
0,0,0,0,0,0,0,0,0,0,0,
0,0,0,0,0,0,0,0,0,0,0,
0,0,0,0,0,0,0,0,0,0,0,
0,0,0,0,0,0,0,0,0,0,0.