[layer]
type=Tile Layer 1
data=
0,0,1,21,1,0,1,21,1,0,0,
0,1,1,1,1,1,1,1,1,1,3,
1,21,1,0,1,21,1,0,1,21,1,
5,1,6,1,5,0,6,1,5,1,6,
1,0,1,1,1,1,1,1,1,0,1,
0,0,1,1,1,1,1,1,1,0,0,
0,0,1,1,1,1,1,1,1,0,0,
0,0,1,1,1,1,1,1,1,0,0,
23,0,1,1,1,1,1,1,1,0,23,
0,0,1,1,1,1,1,1,1,0,0,
0,0,1,1,1,1,1,1,1,0,0,
0,0,1,1,1,1,1,1,1,0,0,
1,0,1,1,1,1,1,1,1,0,1,
4,1,3,1,4,1,3,1,4,0,3,
1,21,1,0,1,21,1,0,1,21,1,
5,1,1,1,0,1,1,1,1,1,6,
0,0,1,21,1,0,1,21,1,0,0,
0,0,0,0,0,0,0,0,0,0,0,
0,0,0,0,0,0,0,0,0,0,0,
0,0,0,0,0,0,0,0,0,0,0,
0,0,0,0,0,0,0,0,0,0,0.
[layer]
type=Tile Layer 2
data=
0,0,109,0,109,0,109,0,109,0,0,
0,105,105,105,105,105,105,105,105,105,105,
116,0,116,0,116,0,116,0,116,0,116,
101,101,101,101,101,0,101,101,101,101,101,
103,0,103,103,103,103,103,103,103,0,103,
0,0,103,103,103,103,103,103,103,0,0,
0,0,103,103,103,103,103,103,103,0,0,
0,0,95,95,95,95,95,95,95,0,0,
0,0,95,95,95,95,95,95,95,0,0,
0,0,93,93,93,93,93,93,93,0,0,
0,0,84,84,84,84,84,84,84,0,0,
0,0,84,84,84,84,84,84,84,0,0,
84,0,84,84,84,84,84,84,84,0,84,
76,76,76,76,76,76,76,76,76,0,76,
84,0,84,0,84,0,84,0,84,0,84,
73,73,73,73,0,73,73,73,73,73,73,
0,0,81,0,81,0,81,0,81,0,0,
0,0,0,0,0,0,0,0,0,0,0,
0,0,0,0,0,0,0,0,0,0,0,
0,0,0,0,0,0,0,0,0,0,0,
0,0,0,0,0,0,0,0,0,0,0.