[layer]
type=Tile Layer 1
data=
2,2,2,2,1,0,2,1,1,2,1,
0,1,2,2,2,2,2,1,2,1,1,
1,2,2,1,2,0,2,2,2,1,1,
1,1,1,1,1,1,1,0,1,1,1,
1,2,2,2,1,1,1,2,2,2,0,
1,2,2,1,2,2,0,2,1,2,1,
2,1,2,1,1,1,2,2,2,2,0,
0,1,0,0,0,1,0,0,0,1,0,
0,1,0,1,0,1,21,1,8,1,0,
21,0,0,2,0,24,0,2,0,2,0,
2,1,1,2,2,2,2,1,21,2,1,
0,0,2,2,0,0,8,0,0,2,21,
2,2,1,2,24,1,1,1,2,2,21,
21,2,1,1,2,2,2,1,1,2,1,
0,2,7,0,0,2,21,2,1,0,0,
21,1,0,2,24,2,0,2,2,1,0,
21,1,2,2,0,2,0,0,0,2,0,
21,1,0,0,0,1,0,24,0,1,0,
2,1,8,1,2,2,0,2,1,1,21,
21,2,1,2,1,2,1,2,2,1,1,
21,2,8,0,0,2,0,0,0,0,0,
2,2,0,1,21,2,24,2,2,1,1,
24,0,0,2,21,2,0,0,0,2,0,
24,1,2,2,0,2,2,2,21,1,1,
0,2,21,24,0,2,2,1,0,0,0,
2,2,21,1,1,1,24,2,2,1,0,
0,0,0,1,0,21,0,1,0,0,0,
2,1,2,2,21,2,0,2,7,2,1,
0,7,0,2,0,2,0,0,21,2,0,
1,1,24,1,21,1,1,1,1,1,0,
0,0,0,2,21,2,2,1,0,0,0,
0,1,21,2,0,2,0,2,0,2,0,
0,2,2,2,0,2,0,0,0,1,21,
0,1,2,2,0,2,21,2,2,1,1,
0,2,0,21,0,2,0,2,0,0,0,
1,1,0,1,1,1,0,1,21,1,1,
0,0,0,2,21,0,0,0,0,2,0,
0,1,1,1,0,1,1,1,1,1,21,
21,1,1,0,0,1,0,0,0,0,0,
21,1,1,1,1,1,0,1,1,1,1,
1,2,1,2,2,1,2,0,2,2,1,
7,1,1,1,1,1,1,1,1,1,21,
1,1,1,1,1,1,1,1,0,1,1,
0,0,0,2,0,2,21,0,0,0,0,
1,1,21,1,0,1,0,1,1,1,1,
0,0,21,2,0,7,0,2,0,0,0,
1,1,1,1,1,1,1,1,21,1,1,
1,1,1,1,1,1,1,1,1,1,21,
0,0,0,0,0,1,0,1,0,0,0,
1,1,1,1,21,1,0,1,0,1,1,
0,0,0,0,0,1,0,0,0,1,21,
0,1,1,1,1,1,1,1,1,1,0,
0,2,2,21,0,0,0,0,2,2,0,
0,2,2,2,0,1,1,1,2,1,0,
21,0,0,0,0,2,0,0,0,2,0,
1,1,1,1,0,1,21,1,0,1,0,
0,0,0,2,2,1,0,1,0,2,21,
21,1,0,1,1,1,0,1,0,1,0,
7,1,0,0,0,21,0,1,0,1,0,
1,1,1,1,1,1,1,1,21,1,0,
0,1,7,0,0,0,1,1,0,0,21,
0,1,21,1,0,1,1,1,1,1,1,
1,1,1,1,1,1,1,1,1,1,21,
21,2,2,1,1,1,1,2,2,2,1,
0,1,0,1,0,0,0,0,21,0,0,
1,1,0,1,21,1,1,1,0,1,1,
21,0,0,1,0,1,1,1,0,7,0,
0,1,1,1,21,1,0,1,1,1,0,
0,1,1,1,1,1,21,1,0,1,1,
0,0,0,1,1,1,0,1,0,0,0,
0,1,0,1,21,1,0,1,1,1,1,
0,0,0,0,0,0,0,0,0,0,0,
0,0,0,0,0,0,0,0,0,0,0,
0,0,0,0,0,0,0,0,0,0,0,
0,0,0,0,0,0,0,0,0,0,0.
[layer]
type=Tile Layer 2
data=
182,182,182,182,182,0,182,182,182,182,182,
0,198,198,198,198,198,198,198,198,198,198,
198,198,198,198,198,0,198,198,198,198,198,
198,198,198,198,198,198,198,0,198,198,198,
182,182,182,182,182,182,182,182,182,182,0,
182,182,182,182,182,182,0,182,182,182,182,
182,182,182,182,182,182,182,182,182,182,0,
0,198,0,0,0,198,0,0,0,198,0,
0,297,0,297,0,297,0,297,0,297,0,
0,0,0,295,0,0,0,295,0,295,0,
180,180,180,180,180,180,180,180,0,180,180,
0,0,268,268,0,0,0,0,0,268,0,
267,267,267,267,0,267,267,267,267,267,0,
0,192,192,192,192,192,192,192,192,192,192,
0,286,0,0,0,286,0,286,286,0,0,
0,285,0,285,0,285,0,285,285,285,0,
0,173,173,173,0,173,0,0,0,173,0,
0,258,0,0,0,258,0,0,0,258,0,
256,256,0,256,256,256,0,256,256,256,0,
0,185,185,185,185,185,185,185,185,185,185,
0,276,0,0,0,276,0,0,0,0,0,
273,273,0,273,0,273,0,273,273,273,273,
0,0,0,250,0,250,0,0,0,250,0,
0,249,249,249,0,249,249,249,0,249,249,
0,247,0,0,0,247,247,247,0,0,0,
267,267,0,267,267,267,0,267,267,267,0,
0,0,0,176,0,0,0,176,0,0,0,
262,262,262,262,0,262,0,262,0,262,262,
0,0,0,240,0,240,0,0,0,240,0,
238,238,0,238,0,238,238,238,238,238,0,
0,0,0,158,0,158,158,158,0,0,0,
0,170,0,170,0,170,0,170,0,170,0,
0,169,169,169,0,169,0,0,0,169,0,
0,168,168,168,0,168,0,168,168,168,168,
0,154,0,0,0,154,0,154,0,0,0,
153,153,0,153,153,153,0,153,0,153,153,
0,0,0,151,0,0,0,0,0,151,0,
0,163,163,163,0,163,163,163,163,163,0,
0,162,162,0,0,162,0,0,0,0,0,
0,161,161,161,161,161,0,161,161,161,161,
147,147,147,147,147,147,147,0,147,147,147,
0,220,220,220,220,220,220,220,220,220,0,
146,146,146,146,146,146,146,146,0,146,146,
0,0,0,158,0,158,0,0,0,0,0,
157,157,0,157,0,157,0,157,157,157,157,
0,0,0,234,0,0,0,234,0,0,0,
143,143,143,143,143,143,143,143,0,143,143,
142,142,142,142,142,142,142,142,142,142,0,
0,0,0,0,0,140,0,140,0,0,0,
152,152,152,152,0,152,0,152,0,152,152,
0,0,0,0,0,151,0,0,0,151,0,
0,150,150,150,150,150,150,150,150,150,0,
0,138,138,0,0,0,0,0,138,138,0,
0,137,137,137,0,137,137,137,137,137,0,
0,0,0,0,0,137,0,0,0,137,0,
148,148,148,148,0,148,0,148,0,148,0,
0,0,0,146,146,146,0,146,0,146,0,
0,145,0,145,145,145,0,145,0,145,0,
0,199,0,0,0,0,0,199,0,199,0,
132,132,132,132,132,132,132,132,0,132,0,
0,196,0,0,0,0,196,196,0,0,0,
0,119,0,119,0,119,119,119,119,119,119,
118,118,118,118,118,118,118,118,118,118,0,
0,117,117,117,117,117,117,117,117,117,117,
0,105,0,105,0,0,0,0,0,0,0,
104,104,0,104,0,104,104,104,0,104,104,
0,0,0,154,0,154,154,154,0,0,0,
0,102,102,102,0,102,0,102,102,102,0,
0,101,101,101,101,101,0,101,0,101,101,
0,0,0,100,100,100,0,100,0,0,0,
0,100,0,100,0,100,0,100,100,100,100,
0,0,0,0,0,0,0,0,0,0,0,
0,0,0,0,0,0,0,0,0,0,0,
0,0,0,0,0,0,0,0,0,0,0,
0,0,0,0,0,0,0,0,0,0,0.