[layer]
type=Tile Layer 1
data=
4,2,0,0,0,0,0,0,1,2,0,
2,6,0,1,2,1,1,2,0,4,3,
0,23,0,1,1,1,1,1,8,5,6,
21,0,1,1,1,1,1,1,1,0,21,
0,1,1,1,1,1,1,1,1,1,0,
0,1,1,1,22,0,22,1,1,1,0,
0,1,2,1,0,0,0,1,1,2,0,
0,1,1,1,0,0,0,1,1,1,0,
0,2,1,1,0,1,0,2,1,1,0,
0,1,1,1,0,1,8,1,1,1,0,
0,2,1,1,0,0,0,1,1,2,0,
24,1,1,1,0,0,0,1,1,1,0,
0,1,2,2,22,0,22,1,1,1,0,
0,2,1,1,1,1,1,2,1,1,0,
0,8,1,1,1,1,1,1,1,0,0,
0,0,21,1,1,1,1,1,21,0,0,
0,0,0,1,1,1,1,1,0,4,3,
0,0,0,0,0,0,0,0,0,0,0,
0,0,0,0,0,0,0,0,0,0,0,
0,0,0,0,0,0,0,0,0,0,0,
0,0,0,0,0,0,0,0,0,0,0.
[layer]
type=Tile Layer 2
data=
105,105,0,0,0,0,0,0,105,105,0,
114,114,0,114,114,114,114,114,0,114,114,
0,0,0,171,171,171,171,171,0,171,171,
0,0,113,113,113,113,113,113,113,0,0,
0,102,102,102,102,102,102,102,102,102,0,
0,102,102,102,0,0,0,102,102,102,0,
0,100,100,100,0,0,0,100,100,100,0,
0,92,92,92,0,0,0,92,92,92,0,
0,92,92,92,0,92,0,92,92,92,0,
0,138,138,138,0,138,0,138,138,138,0,
0,83,83,83,0,0,0,83,83,83,0,
0,124,124,124,0,0,0,124,124,124,0,
0,83,83,83,0,0,0,83,83,83,0,
0,81,81,81,81,81,81,81,81,81,0,
0,0,121,121,121,121,121,121,121,0,0,
0,0,0,81,81,81,81,81,0,0,0,
0,0,0,80,80,80,80,80,0,80,80,
0,0,0,0,0,0,0,0,0,0,0,
0,0,0,0,0,0,0,0,0,0,0,
0,0,0,0,0,0,0,0,0,0,0,
0,0,0,0,0,0,0,0,0,0,0.