[layer]
type=Tile Layer 1
data=
0,0,0,18,21,2,24,16,0,0,0,
17,2,0,17,7,17,0,19,2,2,0,
0,18,24,0,0,2,21,16,0,0,0,
1,1,0,17,1,1,17,17,17,17,1,
1,1,1,0,2,16,18,1,18,18,1,
19,17,19,2,0,2,17,1,1,19,1,
0,1,0,0,24,18,0,0,0,18,0,
1,2,17,17,0,1,0,19,2,19,0,
0,0,21,7,0,18,0,18,0,0,0,
19,19,2,1,0,19,21,19,8,17,1,
0,0,0,16,0,1,0,16,0,8,21,
1,19,21,17,0,17,8,19,2,2,1,
0,7,0,18,0,1,0,2,16,0,21,
0,2,2,2,0,1,8,1,2,1,1,
0,0,18,18,0,18,0,21,7,0,0,
1,1,17,17,1,17,1,1,17,1,21,
1,1,1,1,1,1,21,1,1,1,1,
21,0,0,1,0,0,7,1,1,1,0,
1,16,16,16,1,1,0,1,16,16,1,
7,17,0,17,0,0,0,0,21,0,0,
2,1,21,1,16,18,2,1,18,16,1,
0,19,1,19,1,2,17,19,1,2,1,
0,16,0,0,0,21,0,18,1,2,0,
0,1,1,19,17,2,21,19,17,2,0,
0,18,18,18,0,0,21,18,0,0,0,
17,19,21,2,0,17,2,17,0,2,1,
0,1,21,2,0,2,0,0,0,2,0,
21,1,0,2,0,17,24,1,19,19,0,
0,2,0,2,0,21,0,2,1,0,0,
1,17,2,1,19,2,17,1,1,19,21,
1,16,16,16,16,16,1,1,1,1,0,
0,0,0,0,0,19,21,2,0,17,0,
18,2,2,16,0,18,0,18,21,16,1,
0,19,19,19,21,0,0,19,0,0,0,
0,16,0,2,16,1,2,16,1,2,21,
0,2,0,0,0,21,0,0,0,2,0,
0,2,1,2,2,1,1,2,24,1,21,
0,21,0,17,0,0,0,19,0,2,0,
1,1,21,1,0,1,0,1,0,1,1,
0,1,0,0,0,1,0,1,0,21,0,
1,1,1,1,1,0,1,1,1,1,1,
0,0,21,0,1,17,0,0,0,17,0,
1,1,21,1,1,1,1,1,1,1,7,
21,0,0,0,1,1,0,1,1,1,0,
0,1,1,1,1,1,0,1,0,1,21,
0,21,1,1,0,0,0,1,0,0,0,
18,2,16,18,0,1,2,18,21,16,1,
0,0,0,0,0,1,2,2,0,0,21,
1,1,1,1,1,0,1,1,1,1,1,
17,0,1,17,1,1,17,17,1,1,1,
21,1,16,1,16,16,1,16,1,1,0,
0,0,0,1,1,0,21,1,0,0,0,
1,1,0,1,1,1,0,1,21,1,1,
21,1,0,1,0,0,0,1,0,0,0,
0,2,21,1,0,2,1,1,2,1,0,
0,0,0,2,0,2,0,0,21,0,0,
0,2,1,1,21,2,0,2,1,2,0,
0,2,2,0,0,1,0,21,0,2,0,
0,2,2,2,0,1,2,1,21,1,1,
0,0,0,0,0,1,0,0,21,1,0,
1,1,1,1,21,1,0,1,1,1,1,
21,1,0,0,0,1,0,1,1,0,0,
0,1,0,1,1,1,21,1,1,1,0,
0,1,0,0,0,17,0,0,0,17,21,
1,1,1,1,0,1,1,1,0,1,21,
0,1,0,0,21,1,1,1,0,1,0,
21,1,0,1,1,1,0,1,0,1,1,
0,1,0,17,1,0,0,17,21,17,0,
18,2,0,1,16,18,0,2,21,16,0,
0,1,0,21,0,0,0,1,0,1,0,
0,1,1,1,1,1,0,1,21,1,1,
0,0,0,0,0,0,0,0,0,0,0,
0,0,0,0,0,0,0,0,0,0,0,
0,0,0,0,0,0,0,0,0,0,0,
0,0,0,0,0,0,0,0,0,0,0.
[layer]
type=Tile Layer 2
data=
0,0,0,274,0,274,0,137,0,0,0,
148,297,0,148,0,148,0,297,297,297,0,
0,297,0,0,0,297,0,148,0,0,0,
197,197,0,98,197,197,98,98,98,98,197,
181,181,181,0,181,90,181,181,181,181,181,
181,90,181,181,0,181,90,181,181,181,181,
0,271,0,0,0,271,0,0,0,271,0,
197,197,98,98,0,197,0,197,197,197,0,
0,0,0,0,0,295,0,295,0,0,0,
294,294,294,294,0,294,0,294,0,147,294,
0,0,0,134,0,268,0,134,0,0,0,
267,267,0,133,0,133,0,267,267,267,267,
0,0,0,265,0,265,0,265,132,0,0,
0,286,286,286,0,286,0,286,286,286,286,
0,0,286,286,0,286,0,0,0,0,0,
190,190,95,95,190,95,190,190,95,190,0,
173,173,173,173,173,173,0,173,173,173,173,
0,0,0,258,0,0,0,258,258,258,0,
171,85,85,85,171,171,0,171,85,85,171,
0,139,0,139,0,0,0,0,0,0,0,
185,185,0,185,92,185,185,185,185,92,185,
0,184,184,184,184,184,92,184,184,184,184,
0,84,0,0,0,0,0,169,169,169,0,
0,168,168,168,84,168,0,168,84,168,0,
0,167,167,167,0,0,0,167,0,0,0,
90,180,0,180,0,90,180,90,0,180,180,
0,179,0,179,0,179,0,0,0,179,0,
0,267,0,267,0,133,0,267,267,267,0,
0,162,0,162,0,0,0,162,162,0,0,
161,80,161,161,161,161,80,161,161,161,0,
160,80,80,80,80,80,160,160,160,160,0,
0,0,0,0,0,174,0,174,0,87,0,
173,173,173,86,0,173,0,173,0,86,173,
0,172,172,172,0,0,0,172,0,0,0,
0,78,0,157,78,157,157,78,157,157,0,
0,156,0,0,0,0,0,0,0,156,0,
0,232,232,232,232,232,232,232,0,232,0,
0,0,0,83,0,0,0,167,0,167,0,
166,166,0,166,0,166,0,166,0,166,166,
0,164,0,0,0,164,0,164,0,0,0,
150,150,150,150,150,0,150,150,150,150,150,
0,0,0,0,150,75,0,0,0,75,0,
223,223,0,223,223,223,223,223,223,223,0,
0,0,0,0,161,161,0,161,161,161,0,
0,160,160,160,160,160,0,160,0,160,0,
0,0,158,158,0,0,0,158,0,0,0,
145,145,72,145,0,145,145,145,0,72,145,
0,0,0,0,0,144,144,144,0,0,0,
143,143,143,143,143,0,143,143,143,143,143,
77,0,155,77,155,155,77,77,155,155,155,
0,155,77,155,77,77,155,77,155,155,0,
0,0,0,154,154,0,0,154,0,0,0,
140,140,0,140,140,140,0,140,0,140,140,
0,139,0,139,0,0,0,139,0,0,0,
0,138,0,138,0,138,138,138,138,138,0,
0,0,0,149,0,149,0,0,0,0,0,
0,148,148,148,0,148,0,148,148,148,0,
0,146,146,0,0,146,0,0,0,146,0,
0,134,134,134,0,134,134,134,0,134,134,
0,0,0,0,0,133,0,0,0,133,0,
132,132,132,132,0,132,0,132,132,132,132,
0,120,0,0,0,120,0,120,120,0,0,
0,119,0,119,119,119,0,119,119,119,0,
0,118,0,0,0,59,0,0,0,59,0,
106,106,106,106,0,106,106,106,0,106,0,
0,105,0,0,0,105,105,105,0,105,0,
0,104,0,104,104,104,0,104,0,104,104,
0,103,0,51,103,0,0,51,0,51,0,
102,102,0,102,51,102,0,102,0,51,0,
0,101,0,0,0,0,0,101,0,101,0,
0,100,100,100,100,100,0,100,0,100,100,
0,0,0,0,0,0,0,0,0,0,0,
0,0,0,0,0,0,0,0,0,0,0,
0,0,0,0,0,0,0,0,0,0,0,
0,0,0,0,0,0,0,0,0,0,0.