[layer]
type=Tile Layer 1
data=
0,0,1,0,0,0,0,0,1,0,0,
0,0,1,0,0,0,0,0,1,0,0,
0,0,1,0,0,0,0,0,1,0,0,
0,1,1,1,1,1,1,1,1,1,0,
1,21,1,1,1,1,1,1,1,21,1,
21,1,21,1,1,1,1,1,21,1,21,
1,21,1,1,0,0,0,1,1,21,1,
1,0,0,0,0,0,0,0,0,0,1,
1,0,0,0,1,1,1,0,0,0,1,
1,0,0,0,1,1,1,0,0,0,1,
1,0,0,0,1,1,1,0,0,0,1,
1,0,0,0,0,1,0,0,0,0,1,
1,0,0,0,0,1,1,0,0,0,1,
1,0,0,0,0,1,0,0,0,0,1,
1,0,0,0,0,1,1,0,0,0,1,
1,21,1,0,0,0,0,0,1,21,1,
21,1,21,1,1,1,1,1,21,1,21,
0,0,0,0,0,0,0,0,0,0,0,
0,0,0,0,0,0,0,0,0,0,0,
0,0,0,0,0,0,0,0,0,0,0,
0,0,0,0,0,0,0,0,0,0,0.
[layer]
type=Tile Layer 2
data=
0,0,111,0,0,0,0,0,111,0,0,
0,0,120,0,0,0,0,0,120,0,0,
0,0,120,0,0,0,0,0,120,0,0,
0,120,120,120,120,120,120,120,120,120,0,
111,0,111,111,111,111,111,111,111,0,111,
0,109,0,109,109,109,109,109,0,109,0,
104,0,104,104,0,0,0,104,104,0,104,
94,0,0,0,0,0,0,0,0,0,94,
94,0,0,0,94,94,94,0,0,0,94,
94,0,0,0,94,94,94,0,0,0,94,
85,0,0,0,85,85,85,0,0,0,85,
85,0,0,0,0,85,0,0,0,0,85,
85,0,0,0,0,85,85,0,0,0,85,
85,0,0,0,0,85,0,0,0,0,85,
85,0,0,0,0,85,85,0,0,0,85,
85,0,85,0,0,0,0,0,85,0,85,
0,83,0,83,83,83,83,83,0,83,0,
0,0,0,0,0,0,0,0,0,0,0,
0,0,0,0,0,0,0,0,0,0,0,
0,0,0,0,0,0,0,0,0,0,0,
0,0,0,0,0,0,0,0,0,0,0.