[layer]
type=Tile Layer 1
data=
17,19,19,2,19,2,17,0,1,0,1,
16,1,16,0,1,16,18,2,2,2,1,
2,1,0,1,2,1,1,2,2,2,1,
18,0,18,21,0,0,0,0,8,0,0,
1,17,1,0,1,17,17,1,17,17,1,
0,0,18,0,18,0,0,0,0,0,18,
17,17,2,8,19,0,2,17,2,21,1,
18,0,0,0,18,0,18,21,0,0,1,
2,8,17,19,2,21,17,0,17,2,1,
1,0,18,0,7,0,18,0,18,21,0,
1,0,1,7,1,1,1,0,1,21,1,
0,21,16,0,0,0,16,0,0,0,16,
0,1,17,17,2,17,19,2,2,19,1,
21,0,0,0,18,8,0,0,1,18,1,
19,17,2,0,2,17,17,0,2,21,1,
2,21,0,0,18,1,18,0,16,8,1,
17,21,17,1,17,8,17,0,1,0,1,
0,0,0,0,0,0,18,21,18,0,0,
17,2,2,17,19,2,17,21,17,2,1,
18,0,24,0,0,0,18,0,0,0,21,
19,8,2,1,19,21,19,17,1,1,1,
0,0,18,18,18,0,24,0,0,21,0,
1,1,0,1,17,17,17,1,17,1,1,
2,0,0,24,0,21,0,0,0,0,2,
17,21,1,1,19,2,19,17,2,8,1,
18,21,18,0,0,24,0,0,18,0,0,
1,24,2,0,1,2,2,21,1,2,1,
16,21,16,0,16,16,7,0,0,0,1,
17,0,2,0,19,2,19,1,17,0,1,
2,0,2,0,0,0,2,0,0,21,2,
17,21,1,1,17,0,17,0,17,1,1,
16,0,0,21,0,0,16,0,0,0,0,
1,19,17,0,19,17,2,2,17,1,1,
2,1,2,8,1,1,2,0,2,21,1,
0,2,2,0,0,0,0,0,2,0,21,
1,1,1,1,1,1,1,0,1,1,1,
0,0,0,17,1,0,0,0,17,21,0,
1,0,1,1,1,1,1,1,1,1,1,
21,0,19,0,0,0,19,0,19,0,1,
1,1,1,0,1,1,1,21,1,24,1,
0,0,0,0,17,1,1,21,17,0,0,
1,1,1,1,1,21,1,1,1,1,1,
0,0,19,19,21,0,0,0,0,0,19,
1,1,1,1,1,1,1,1,1,24,1,
1,1,1,1,1,8,1,1,1,1,1,
0,0,0,0,1,0,21,0,0,0,1,
1,1,1,21,1,1,1,1,1,0,1,
0,1,1,21,0,0,1,0,0,0,1,
2,2,2,2,1,21,1,0,1,2,1,
0,0,0,1,1,21,1,0,0,0,1,
1,0,1,1,1,21,1,1,1,0,1,
1,21,0,0,0,0,1,1,1,0,0,
1,2,2,1,2,2,2,21,1,1,1,
1,1,1,1,1,1,1,0,1,21,1,
0,0,0,0,1,1,1,0,0,21,1,
1,1,1,21,2,0,1,2,2,2,1,
17,21,0,0,17,0,0,0,0,0,17,
1,7,1,1,16,21,16,16,16,0,1,
0,21,2,0,0,0,2,0,0,0,2,
1,1,2,0,2,1,1,21,2,2,1,
1,1,0,0,0,1,1,21,0,0,0,
1,1,1,1,1,1,1,21,1,1,1,
0,0,1,7,0,0,1,21,0,0,0,
1,0,1,1,1,1,1,1,1,1,1,
1,0,0,0,1,21,1,0,0,0,0,
1,1,1,1,1,1,1,21,1,1,1,
0,0,0,0,0,0,0,0,0,0,0,
0,0,0,0,0,0,0,0,0,0,0,
0,0,0,0,0,0,0,0,0,0,0,
0,0,0,0,0,0,0,0,0,0,0.
[layer]
type=Tile Layer 2
data=
88,177,177,177,177,177,88,0,177,0,177,
88,177,88,0,177,88,177,177,177,177,177,
192,192,0,192,192,192,192,192,192,192,192,
288,0,288,0,0,0,0,0,0,0,0,
191,95,191,0,191,95,95,191,95,95,191,
0,0,176,0,176,0,0,0,0,0,176,
132,132,264,0,264,0,264,132,264,0,264,
175,0,0,0,175,0,175,0,0,0,175,
282,0,141,282,282,0,141,0,141,282,282,
280,0,280,0,0,0,280,0,280,0,0,
279,0,279,0,279,279,279,0,279,0,279,
0,0,85,0,0,0,85,0,0,0,85,
0,169,84,84,169,84,169,169,169,169,169,
0,0,0,0,253,0,0,0,253,253,253,
182,91,182,0,182,91,91,0,182,0,182,
271,0,0,0,271,271,271,0,135,0,271,
135,0,135,270,135,0,135,0,270,0,270,
0,0,0,0,0,0,165,0,165,0,0,
82,164,164,82,164,164,82,0,82,164,164,
243,0,0,0,0,0,243,0,0,0,0,
262,0,262,262,262,0,262,131,262,262,262,
0,0,261,261,261,0,0,0,0,0,0,
173,173,0,173,86,86,86,173,86,173,173,
238,0,0,0,0,0,0,0,0,0,238,
118,0,237,237,237,237,237,118,237,0,237,
235,0,235,0,0,0,0,0,235,0,0,
253,0,253,0,253,253,253,0,253,253,253,
126,0,126,0,126,126,0,0,0,0,252,
83,0,167,0,167,167,167,167,83,0,167,
154,0,154,0,0,0,154,0,0,0,154,
76,0,153,153,76,0,76,0,76,153,153,
75,0,0,0,0,0,75,0,0,0,0,
163,163,81,0,163,81,163,163,81,163,163,
244,244,244,0,244,244,244,0,244,0,244,
0,162,162,0,0,0,0,0,162,0,0,
148,148,148,148,148,148,148,0,148,148,148,
0,0,0,74,148,0,0,0,74,0,0,
147,0,147,147,147,147,147,147,147,147,147,
0,0,160,0,0,0,160,0,160,0,160,
237,237,237,0,237,237,237,0,237,0,237,
0,0,0,0,78,157,157,0,78,0,0,
144,144,144,144,144,0,144,144,144,144,144,
0,0,143,143,0,0,0,0,0,0,143,
213,213,213,213,213,213,213,213,213,0,213,
231,231,231,231,231,0,231,231,231,231,231,
0,0,0,0,154,0,0,0,0,0,154,
152,152,152,0,152,152,152,152,152,0,152,
0,139,139,0,0,0,139,0,0,0,139,
138,138,138,138,138,0,138,0,138,138,138,
0,0,0,137,137,0,137,0,0,0,137,
148,0,148,148,148,0,148,148,148,0,148,
146,0,0,0,0,0,146,146,146,0,0,
145,145,145,145,145,145,145,0,145,145,145,
133,133,133,133,133,133,133,0,133,0,133,
0,0,0,0,132,132,132,0,0,0,132,
131,131,131,0,131,0,131,131,131,131,131,
59,0,0,0,59,0,0,0,0,0,59,
177,0,177,177,88,0,88,88,88,0,177,
0,0,117,0,0,0,117,0,0,0,117,
105,105,105,0,105,105,105,0,105,105,105,
104,104,0,0,0,104,104,0,0,0,0,
103,103,103,103,103,103,103,0,103,103,103,
0,0,153,0,0,0,153,0,0,0,0,
101,0,101,101,101,101,101,101,101,101,101,
101,0,0,0,101,0,101,0,0,0,0,
100,100,100,100,100,100,100,0,100,100,100,
0,0,0,0,0,0,0,0,0,0,0,
0,0,0,0,0,0,0,0,0,0,0,
0,0,0,0,0,0,0,0,0,0,0,
0,0,0,0,0,0,0,0,0,0,0.