[layer]
type=Tile Layer 1
data=
1,1,1,1,0,0,0,1,1,1,1,
0,1,1,1,0,0,0,1,1,1,0,
0,1,1,1,0,0,0,1,1,1,0,
0,1,0,1,0,0,0,1,0,1,0,
1,0,0,0,2,24,2,0,0,0,1,
0,0,0,0,0,0,0,0,0,0,0,
0,0,0,0,0,0,0,0,0,0,0,
0,0,0,0,0,0,0,0,0,0,0,
0,0,0,0,0,0,0,0,0,0,0,
0,0,0,0,0,0,0,0,0,0,0,
0,0,0,0,0,0,0,0,0,0,0.
[layer]
type=Tile Layer 2
data=
27,27,27,27,0,0,0,27,27,27,27,
0,31,31,31,0,0,0,31,31,31,0,
0,31,31,31,0,0,0,31,31,31,0,
0,31,0,31,0,0,0,31,0,31,0,
46,0,0,0,46,0,46,0,0,0,46,
0,0,0,0,0,0,0,0,0,0,0,
0,0,0,0,0,0,0,0,0,0,0,
0,0,0,0,0,0,0,0,0,0,0,
0,0,0,0,0,0,0,0,0,0,0,
0,0,0,0,0,0,0,0,0,0,0,
0,0,0,0,0,0,0,0,0,0,0.