[layer]
type=Tile Layer 1
data=
17,19,6,17,2,19,19,5,19,0,1,
0,0,2,16,16,2,5,18,2,16,1,
2,19,2,0,1,17,2,17,19,17,1,
1,1,3,6,3,1,1,1,0,1,1,
0,17,19,2,19,17,2,19,19,1,1,
18,16,2,0,16,18,16,18,2,1,1,
2,2,1,0,0,21,0,2,2,2,1,
18,18,18,0,0,0,0,21,0,18,18,
1,17,17,5,17,17,1,17,21,24,0,
5,18,16,2,18,4,2,1,18,16,21,
19,2,2,19,1,1,2,17,17,17,21,
3,2,2,1,2,2,1,6,2,2,0,
2,17,19,19,19,19,19,4,21,0,1,
2,2,1,2,2,3,1,2,1,21,0,
2,17,6,17,2,17,19,19,2,21,0,
2,2,16,16,6,18,1,18,18,21,0,
3,2,19,19,2,17,1,19,1,17,21,
16,16,1,1,16,1,1,16,1,16,21,
6,1,1,19,17,17,19,2,19,2,21,
2,18,2,1,18,16,18,16,0,0,21,
17,2,19,19,19,2,19,4,21,17,1,
18,16,18,18,2,2,18,16,21,4,1,
17,17,17,5,17,17,1,21,24,17,1,
16,16,1,1,16,16,1,21,16,16,1,
2,19,2,0,2,19,19,17,3,17,1,
21,0,16,2,18,1,16,2,5,18,1,
0,0,24,0,19,1,17,19,2,1,1,
16,5,2,21,0,18,18,18,16,2,1,
17,17,17,17,21,17,4,17,1,4,1,
1,16,16,16,21,16,1,1,16,16,1,
0,0,0,21,7,17,17,1,17,3,1,
0,21,0,0,0,1,16,16,16,6,1,
2,1,2,2,21,2,2,1,3,2,1,
3,16,16,16,7,21,1,16,16,16,1,
19,19,19,17,19,0,21,19,1,2,1,
2,18,18,1,18,24,21,18,16,18,1,
19,19,19,17,19,0,7,21,19,2,1,
18,18,18,18,0,21,0,0,18,18,1,
17,17,17,1,21,17,6,17,17,6,1,
18,18,18,1,0,21,18,18,18,1,1,
6,1,1,1,3,0,21,1,4,1,1,
2,2,2,2,1,2,0,24,0,2,1,
1,5,1,1,1,0,0,0,21,3,1,
1,3,1,1,1,0,0,21,0,5,1,
17,17,19,19,19,5,19,2,21,2,1,
8,21,6,1,1,6,1,4,1,1,1,
21,0,1,6,5,1,1,1,1,6,1,
4,21,0,1,6,5,1,1,1,1,1,
4,1,0,21,1,1,3,1,1,5,1,
2,2,2,0,0,0,21,0,2,2,1,
17,1,17,17,1,17,17,21,17,1,1,
3,2,2,2,2,2,2,21,0,1,1,
2,2,1,2,2,1,1,2,21,0,0,
6,1,1,1,1,1,1,3,0,21,0,
1,4,1,1,1,6,3,1,21,1,1,
1,4,1,4,1,5,1,1,21,1,1,
1,1,5,1,4,1,1,4,21,1,1,
1,1,1,1,1,1,4,3,21,0,0,
4,3,1,1,3,1,1,1,1,1,21,
2,6,1,2,2,1,2,3,2,1,21,
17,17,17,17,17,0,0,21,0,0,0,
1,4,1,6,1,0,21,0,0,0,0,
2,2,2,2,2,1,1,1,0,21,0,
1,1,6,1,6,1,1,3,21,1,1,
6,1,4,1,1,1,5,1,21,0,1,
1,2,2,2,2,6,1,2,1,0,21,
0,1,1,6,1,1,3,1,1,1,1,
2,1,16,16,2,2,16,18,18,0,21,
17,1,1,17,17,17,17,1,5,21,8,
1,4,1,3,1,1,1,0,21,0,0,
2,1,2,1,2,2,2,21,0,2,1,
4,1,3,4,1,1,1,1,21,1,1,
1,1,1,3,1,1,3,1,0,0,21,
2,2,2,2,5,1,1,1,1,2,21,
6,1,1,5,6,1,1,1,1,1,21,
1,1,6,4,6,21,1,1,1,1,1,
0,0,0,0,0,0,0,0,0,0,0,
0,0,0,0,0,0,0,0,0,0,0,
0,0,0,0,0,0,0,0,0,0,0,
0,0,0,0,0,0,0,0,0,0,0.
[layer]
type=Tile Layer 2
data=
71,142,142,71,142,142,142,142,142,0,142,
0,0,162,81,81,162,162,162,162,81,162,
142,142,142,0,142,71,142,71,142,71,142,
130,130,130,130,130,130,130,130,0,130,130,
0,65,130,130,130,65,130,130,130,130,130,
130,65,130,0,65,130,65,130,130,130,130,
202,202,202,0,0,0,0,202,202,202,202,
200,200,200,0,0,0,0,0,0,200,200,
268,134,134,268,134,134,268,134,0,0,0,
128,128,64,128,128,128,128,128,128,64,0,
127,127,127,127,127,127,127,63,63,63,0,
127,127,127,127,127,127,127,127,127,127,0,
157,78,157,157,157,157,157,157,0,0,157,
156,156,156,156,156,156,156,156,156,0,0,
155,77,155,77,155,77,155,155,155,0,0,
141,141,70,70,141,141,141,141,141,0,0,
123,123,123,123,123,61,123,123,123,61,0,
61,61,122,122,61,122,122,61,122,61,0,
132,132,132,132,66,66,132,132,132,132,0,
168,168,168,168,168,84,168,84,0,0,0,
65,131,131,131,131,131,131,131,0,65,131,
119,59,119,119,119,119,119,59,0,119,119,
102,102,102,204,102,102,204,0,0,102,204,
59,59,118,118,59,59,118,0,59,59,118,
127,127,127,0,127,127,127,63,127,63,127,
0,0,72,145,145,145,72,145,145,145,145,
0,0,0,0,270,270,135,270,270,270,270,
66,132,132,0,0,132,132,132,66,132,132,
58,58,58,58,0,58,116,58,116,116,116,
115,57,57,57,0,57,115,115,57,57,115,
0,0,0,0,0,132,132,264,132,264,264,
0,0,0,0,0,175,87,87,87,175,175,
122,122,122,122,0,122,122,122,122,122,122,
190,95,95,95,0,0,190,95,95,95,190,
127,127,127,63,127,0,0,127,127,127,127,
189,189,189,189,189,0,0,189,94,189,189,
228,228,228,114,228,0,0,0,228,228,228,
168,168,168,168,0,0,0,0,168,168,168,
59,59,59,118,0,59,118,59,59,118,118,
122,122,122,122,0,0,122,122,122,122,122,
121,121,121,121,121,0,0,121,121,121,121,
201,201,201,201,201,201,0,0,0,201,201,
163,163,163,163,163,0,0,0,0,163,163,
162,162,162,162,162,0,0,0,0,162,162,
56,56,113,113,113,113,113,113,0,113,113,
0,0,177,177,177,177,177,177,177,177,177,
0,0,117,117,117,117,117,117,117,117,117,
116,0,0,116,116,116,116,116,116,116,116,
125,125,0,0,125,125,125,125,125,125,125,
155,155,155,0,0,0,0,0,155,155,155,
54,108,54,54,108,54,54,0,54,108,108,
112,112,112,112,112,112,112,0,0,112,112,
125,125,125,125,125,125,125,125,0,0,0,
123,123,123,123,123,123,123,123,0,0,0,
104,104,104,104,104,104,104,104,0,104,104,
104,104,104,104,104,104,104,104,0,104,104,
103,103,103,103,103,103,103,103,0,103,103,
120,120,120,120,120,120,120,120,0,0,0,
93,93,93,93,93,93,93,93,93,93,0,
93,93,93,93,93,93,93,93,93,93,0,
71,71,71,71,71,0,0,0,0,0,0,
140,140,140,140,140,0,0,0,0,0,0,
125,125,125,125,125,125,125,125,0,0,0,
89,89,89,89,89,89,89,89,0,89,89,
100,100,100,100,100,100,100,100,0,0,100,
100,100,100,100,100,100,100,100,100,0,0,
0,80,80,80,80,80,80,80,80,80,80,
91,91,45,45,91,91,45,91,91,0,0,
67,135,135,67,67,67,67,135,135,0,0,
100,100,100,100,100,100,100,0,0,0,0,
79,79,79,79,79,79,79,0,0,79,79,
69,69,69,69,69,69,69,69,0,69,69,
87,87,87,87,87,87,87,87,0,0,0,
68,68,68,68,68,68,68,68,68,68,0,
67,67,67,67,67,67,67,67,67,67,0,
67,67,67,67,67,0,67,67,67,67,67,
0,0,0,0,0,0,0,0,0,0,0,
0,0,0,0,0,0,0,0,0,0,0,
0,0,0,0,0,0,0,0,0,0,0,
0,0,0,0,0,0,0,0,0,0,0.