[layer]
type=Tile Layer 1
data=
2,2,1,1,2,6,0,2,1,2,1,
1,1,3,1,1,1,6,1,0,1,1,
1,1,1,6,1,3,1,1,6,8,1,
2,2,0,0,0,0,0,21,2,0,0,
2,2,3,0,2,3,2,0,1,1,1,
0,0,0,0,2,0,0,0,6,2,1,
1,2,2,1,2,2,5,1,1,0,1,
2,1,1,5,5,2,1,2,0,2,1,
0,2,2,1,2,1,2,2,1,1,1,
1,2,2,0,2,1,6,5,1,2,1,
2,1,1,21,2,0,2,8,1,2,1,
2,0,0,0,1,21,0,0,1,2,0,
2,21,2,5,1,4,2,2,1,3,1,
2,0,0,21,0,0,0,7,0,0,2,
1,6,2,2,2,2,1,2,5,21,1,
0,0,0,0,2,0,21,0,0,7,2,
2,1,2,1,2,6,0,1,2,2,1,
0,0,0,0,2,0,2,0,8,21,0,
1,1,5,6,5,0,1,21,1,1,1,
0,7,0,21,2,0,1,0,2,1,0,
1,2,3,7,2,0,1,21,2,2,1,
0,0,0,0,2,0,2,0,0,21,1,
2,2,2,2,1,2,3,3,1,21,1,
2,1,2,2,1,1,2,2,0,1,1,
2,1,2,1,6,1,2,2,0,2,1,
1,1,2,5,1,1,2,2,2,2,0,
2,8,2,3,2,1,2,5,1,21,1,
0,0,1,0,21,0,0,6,1,0,0,
1,4,3,21,1,1,2,2,2,2,1,
5,0,2,21,5,1,1,2,2,2,1,
1,1,3,0,1,5,1,0,1,0,1,
0,0,21,0,3,0,0,0,1,1,1,
1,4,2,2,1,7,2,21,2,2,1,
2,3,2,1,0,1,2,5,2,2,1,
3,2,3,1,2,1,2,2,2,21,1,
6,1,1,0,1,4,1,1,1,4,1,
1,1,1,5,1,1,4,1,1,5,0,
1,4,0,0,0,7,21,0,1,0,1,
1,1,5,0,1,1,5,0,1,21,1,
0,0,0,21,5,0,0,7,1,0,0,
5,1,1,6,1,5,1,1,1,1,0,
0,21,0,0,0,0,5,0,0,0,1,
2,2,5,2,1,2,2,8,4,21,1,
0,0,0,0,21,0,0,0,3,0,1,
6,1,1,5,1,0,1,1,3,21,1,
21,0,0,7,0,0,3,0,0,0,1,
1,2,4,2,2,2,2,21,1,1,1,
2,1,3,6,1,2,0,2,4,2,1,
4,1,1,1,1,4,1,0,5,1,1,
2,0,0,0,21,0,0,7,2,0,2,
1,0,5,1,3,1,1,0,1,21,1,
0,0,1,0,0,21,24,0,6,0,1,
6,1,1,21,1,1,3,1,3,0,1,
0,1,1,1,3,4,6,1,1,1,1,
1,3,5,1,1,21,1,0,1,5,1,
0,0,0,0,0,0,2,0,2,0,0,
6,6,1,1,1,1,1,0,5,21,1,
0,0,0,0,1,21,0,0,4,0,0,
5,1,3,0,1,0,1,1,1,21,1,
5,1,1,0,1,21,0,0,3,0,0,
1,0,1,21,1,6,1,0,1,4,1,
21,0,3,0,0,0,0,0,1,1,0,
1,2,2,2,1,2,3,21,2,1,1,
1,3,0,6,1,1,6,1,1,1,1,
0,21,0,4,4,0,1,0,24,1,1,
1,1,1,6,6,21,3,0,1,1,1,
0,0,0,0,0,0,0,0,0,0,0,
0,0,0,0,0,0,0,0,0,0,0,
0,0,0,0,0,0,0,0,0,0,0,
0,0,0,0,0,0,0,0,0,0,0.
[layer]
type=Tile Layer 2
data=
167,167,167,167,167,167,0,167,167,167,167,
167,167,167,167,167,167,167,167,0,167,167,
271,271,271,271,271,271,271,271,271,0,271,
181,181,0,0,0,0,0,0,181,0,0,
180,180,180,0,180,180,180,0,180,180,180,
0,0,0,0,166,0,0,0,166,166,166,
166,166,166,166,166,166,166,166,166,0,166,
166,166,166,166,166,166,166,166,0,166,166,
0,180,180,180,180,180,180,180,180,180,180,
180,180,180,0,180,180,180,180,180,180,180,
270,270,270,0,270,0,270,0,270,270,270,
165,0,0,0,165,0,0,0,165,165,0,
164,0,164,164,164,164,164,164,164,164,164,
243,0,0,0,0,0,0,0,0,0,243,
175,175,175,175,175,175,175,175,175,0,175,
0,0,0,0,261,0,0,0,0,0,261,
173,173,173,173,173,173,0,173,173,173,173,
0,0,0,0,238,0,238,0,0,0,0,
158,158,158,158,158,0,158,0,158,158,158,
0,0,0,0,235,0,235,0,235,235,0,
253,253,253,0,253,0,253,0,253,253,253,
0,0,0,0,168,0,168,0,0,0,168,
167,167,167,167,167,167,167,167,167,0,167,
153,153,153,153,153,153,153,153,0,153,153,
153,153,153,153,153,153,153,153,0,153,153,
153,153,153,153,153,153,153,153,153,153,0,
249,0,249,249,249,249,249,249,249,0,249,
0,0,164,0,0,0,0,164,164,0,0,
163,163,163,0,163,163,163,163,163,163,163,
149,0,149,0,149,149,149,149,149,149,149,
148,148,148,0,148,148,148,0,148,0,148,
0,0,0,0,148,0,0,0,148,148,148,
240,240,240,240,240,0,240,0,240,240,240,
158,158,158,158,0,158,158,158,158,158,158,
158,158,158,158,158,158,158,158,158,0,158,
145,145,145,0,145,145,145,145,145,145,145,
145,145,145,145,145,145,145,145,145,145,0,
217,217,0,0,0,0,0,0,217,0,217,
156,156,156,0,156,156,156,0,156,0,156,
0,0,0,0,232,0,0,0,232,0,0,
154,154,154,154,154,154,154,154,154,154,0,
0,0,0,0,0,0,142,0,0,0,142,
210,210,210,210,210,210,210,0,210,0,210,
0,0,0,0,0,0,0,0,139,0,139,
150,150,150,150,150,0,150,150,150,0,150,
0,0,0,0,0,0,223,0,0,0,223,
148,148,148,148,148,148,148,0,148,148,148,
135,135,135,135,135,135,0,135,135,135,135,
135,135,135,135,135,135,135,0,135,135,135,
202,0,0,0,0,0,0,0,202,0,202,
145,0,145,145,145,145,145,0,145,0,145,
0,0,216,0,0,0,0,0,216,0,216,
143,143,143,0,143,143,143,143,143,0,143,
0,131,131,131,131,131,131,131,131,131,131,
131,131,131,131,131,0,131,0,131,131,131,
0,0,0,0,0,0,129,0,129,0,0,
119,119,119,119,119,119,119,0,119,0,119,
0,0,0,0,118,0,0,0,118,0,0,
117,117,117,0,117,0,117,117,117,0,117,
105,105,105,0,105,0,0,0,105,0,0,
104,0,104,0,104,104,104,0,104,104,104,
0,0,103,0,0,0,0,0,103,103,0,
102,102,102,102,102,102,102,0,102,102,102,
101,101,0,101,101,101,101,101,101,101,101,
0,0,0,151,151,0,151,0,0,151,151,
100,100,100,100,100,0,100,0,100,100,100,
0,0,0,0,0,0,0,0,0,0,0,
0,0,0,0,0,0,0,0,0,0,0,
0,0,0,0,0,0,0,0,0,0,0,
0,0,0,0,0,0,0,0,0,0,0.