[layer]
type=Tile Layer 1
data=
0,3,2,2,1,2,1,1,2,2,1,
0,0,0,8,19,17,0,0,0,2,0,
2,1,16,1,16,18,2,18,16,2,0,
19,19,0,19,1,2,1,2,17,17,1,
18,18,2,2,16,0,1,1,16,4,1,
0,0,21,0,0,19,0,0,2,17,0,
18,5,4,18,8,18,0,18,1,18,1,
7,2,21,0,0,2,0,4,0,0,0,
1,16,16,16,16,16,0,5,1,6,1,
0,0,0,17,8,0,0,1,0,17,21,
16,2,21,18,7,18,2,1,0,16,0,
0,17,17,17,21,0,0,0,0,17,0,
21,1,1,5,1,1,1,4,1,5,1,
2,2,21,1,6,3,2,2,1,1,1,
7,0,0,16,18,2,0,0,21,0,0,
1,19,1,2,19,1,21,19,17,19,1,
4,16,16,1,16,1,1,16,21,16,1,
21,0,0,19,7,0,0,0,0,19,0,
1,5,16,18,2,16,16,2,2,18,0,
0,19,21,0,0,19,0,0,0,7,0,
1,18,18,16,2,3,21,2,16,18,1,
21,0,0,0,0,19,0,0,0,19,0,
0,1,16,4,0,1,16,16,21,16,1,
0,19,19,0,21,0,0,19,0,0,0,
1,16,16,1,16,1,21,1,16,16,1,
0,0,0,2,1,21,0,0,24,2,0,
0,1,21,1,18,18,1,5,7,18,0,
0,19,0,0,0,0,0,19,0,0,21,
21,2,18,18,16,5,0,18,1,4,1,
0,1,0,0,0,21,0,6,1,1,0,
0,16,0,0,0,16,0,0,21,1,0,
1,1,2,2,0,1,21,1,2,2,0,
0,21,0,1,0,4,0,0,0,1,0,
6,1,21,5,0,1,0,1,0,1,0,
0,3,21,0,0,1,0,1,0,0,0,
0,1,2,3,2,2,21,4,6,2,1,
0,0,0,1,4,0,21,0,0,1,0,
1,1,21,5,1,5,1,1,0,1,0,
21,0,0,1,0,0,0,6,1,1,0,
21,2,1,2,0,1,0,2,1,2,0,
0,3,21,0,0,1,0,0,0,0,0,
2,1,0,5,6,6,2,2,21,2,1,
0,0,0,18,0,0,0,0,21,18,0,
1,1,3,6,21,5,1,1,1,1,0,
0,0,0,1,0,0,0,0,21,6,0,
4,1,8,3,1,6,1,1,21,1,1,
0,16,4,1,16,16,16,16,1,1,1,
0,0,0,1,4,1,21,0,0,0,0,
0,3,0,16,16,16,21,1,1,16,1,
0,1,0,21,0,0,0,6,0,0,0,
5,16,16,16,16,4,4,1,21,1,7,
0,1,0,21,0,0,0,0,0,5,0,
21,1,0,6,4,1,1,1,1,1,0,
0,0,0,2,21,0,0,0,0,2,0,
1,4,1,3,0,1,3,1,21,1,1,
0,4,1,1,6,1,21,1,1,1,0,
0,0,0,6,2,2,0,0,0,1,21,
1,4,0,1,0,1,1,6,21,1,1,
0,1,0,0,0,1,3,1,0,21,0,
3,3,1,1,0,1,21,1,1,1,0,
0,0,0,1,21,0,0,1,1,4,0,
0,0,0,0,0,0,0,0,0,0,0,
0,0,0,0,0,0,0,0,0,0,0,
0,0,0,0,0,0,0,0,0,0,0,
0,0,0,0,0,0,0,0,0,0,0.
[layer]
type=Tile Layer 2
data=
0,148,148,148,148,148,148,148,148,148,148,
0,0,0,0,247,123,0,0,0,247,0,
148,148,74,148,74,148,148,148,74,148,0,
161,161,0,161,161,161,161,161,80,80,161,
161,161,161,161,80,0,161,161,80,161,161,
0,0,0,0,0,179,0,0,179,89,0,
246,246,246,246,0,246,0,246,246,246,246,
0,246,0,0,0,246,0,246,0,0,0,
147,73,73,73,73,73,0,147,147,147,147,
0,0,0,132,0,0,0,265,0,132,0,
131,262,0,262,0,262,262,262,0,131,0,
0,87,87,87,0,0,0,0,0,87,0,
0,144,144,144,144,144,144,144,144,144,144,
143,143,0,143,143,143,143,143,143,143,143,
0,0,0,117,235,235,0,0,0,0,0,
153,153,153,153,153,153,0,153,76,153,153,
151,75,75,151,75,151,151,75,0,75,151,
0,0,0,250,0,0,0,0,0,250,0,
137,137,68,137,137,68,68,137,137,137,0,
0,229,0,0,0,229,0,0,0,0,0,
137,137,137,68,137,137,0,137,68,137,137,
0,0,0,0,0,163,0,0,0,163,0,
0,162,81,162,0,162,81,81,0,81,162,
0,161,161,0,0,0,0,161,0,0,0,
133,66,66,133,66,133,0,133,66,66,133,
0,0,0,219,219,0,0,0,0,219,0,
0,217,0,217,217,217,217,217,0,217,0,
0,156,0,0,0,0,0,156,0,0,0,
0,155,155,155,77,155,0,155,155,155,155,
0,154,0,0,0,0,0,154,154,154,0,
0,70,0,0,0,70,0,0,0,141,0,
139,139,139,139,0,139,0,139,139,139,0,
0,0,0,138,0,138,0,0,0,138,0,
149,149,0,149,0,149,0,149,0,149,0,
0,148,0,0,0,148,0,148,0,0,0,
0,147,147,147,147,147,0,147,147,147,147,
0,0,0,134,134,0,0,0,0,134,0,
133,133,0,133,133,133,133,133,0,133,0,
0,0,0,132,0,0,0,132,132,132,0,
0,142,142,142,0,142,0,142,142,142,0,
0,141,0,0,0,141,0,0,0,0,0,
139,139,0,139,139,139,139,139,0,139,139,
0,0,0,127,0,0,0,0,0,127,0,
126,126,126,126,0,126,126,126,126,126,0,
0,0,0,125,0,0,0,0,0,125,0,
202,202,0,202,202,202,202,202,0,202,202,
0,60,120,120,60,60,60,60,120,120,120,
0,0,0,133,133,133,0,0,0,0,0,
0,122,0,61,61,61,0,122,122,61,122,
0,121,0,0,0,0,0,121,0,0,0,
180,90,90,90,90,180,180,180,0,180,0,
0,109,0,0,0,0,0,0,0,109,0,
0,108,0,108,108,108,108,108,108,108,0,
0,0,0,107,0,0,0,0,0,107,0,
96,96,96,96,0,96,96,96,0,96,96,
0,95,95,95,95,95,0,95,95,95,0,
0,0,0,94,94,94,0,0,0,94,0,
93,93,0,93,0,93,93,93,0,93,93,
0,92,0,0,0,92,92,92,0,0,0,
91,91,91,91,0,91,0,91,91,91,0,
0,0,0,90,0,0,0,90,90,90,0,
0,0,0,0,0,0,0,0,0,0,0,
0,0,0,0,0,0,0,0,0,0,0,
0,0,0,0,0,0,0,0,0,0,0,
0,0,0,0,0,0,0,0,0,0,0.