[layer]
type=Tile Layer 1
data=
0,24,0,0,21,0,1,2,2,0,1,
2,1,1,17,19,0,2,19,19,1,1,
1,2,2,2,1,1,1,0,1,2,1,
1,2,2,1,1,21,1,2,2,2,1,
0,16,1,16,1,16,1,16,1,16,1,
19,19,17,0,19,24,2,0,0,0,1,
2,18,18,0,18,0,16,7,0,0,1,
2,1,2,24,1,21,1,2,2,1,1,
18,18,18,0,18,0,0,0,0,0,21,
2,17,17,21,2,19,17,1,2,24,1,
16,18,1,21,2,1,18,1,18,8,1,
17,17,1,21,17,1,1,17,1,1,1,
0,0,18,21,1,24,0,0,18,18,1,
0,19,17,19,17,2,1,2,17,2,1,
1,2,1,21,1,1,2,1,2,2,1,
0,21,0,0,19,19,1,0,0,0,1,
2,18,16,1,18,18,16,21,2,0,1,
0,0,21,0,17,1,17,0,1,0,1,
0,0,21,0,1,2,16,0,1,18,1,
17,1,17,2,19,21,2,19,2,17,1,
0,0,21,0,18,0,1,16,2,0,0,
2,1,17,21,17,2,19,1,19,0,1,
0,0,0,0,21,0,1,1,1,0,1,
2,19,17,2,0,1,19,19,17,1,1,
1,16,16,16,16,0,21,0,0,0,0,
1,2,1,2,2,21,2,1,1,2,1,
2,16,2,0,18,18,16,0,21,0,1,
19,17,2,0,19,21,19,0,0,0,1,
18,18,16,0,18,0,2,0,21,0,1,
2,1,1,8,1,21,2,2,2,1,1,
18,18,18,0,18,21,0,0,0,0,0,
19,2,1,21,1,17,17,2,19,0,1,
1,1,16,0,16,1,1,16,16,0,1,
1,1,1,21,1,1,1,1,1,1,1,
0,0,1,0,1,0,21,8,1,1,1,
21,0,1,0,1,0,0,0,1,1,1,
1,1,1,21,2,2,2,2,1,1,1,
24,0,0,0,1,1,1,21,0,0,1,
1,1,1,1,1,1,1,24,1,21,1,
0,0,21,0,1,1,1,0,1,0,1,
0,0,21,0,16,1,16,0,1,1,1,
1,1,1,1,1,1,1,1,1,1,21,
0,1,16,1,1,1,0,16,16,16,0,
2,1,19,17,2,2,21,17,17,1,0,
0,1,1,1,1,1,21,1,1,1,0,
1,1,1,2,2,2,21,1,2,2,1,
1,16,1,1,1,1,16,1,16,16,21,
21,0,0,0,0,17,1,1,1,17,0,
16,1,21,1,1,16,1,16,1,16,0,
2,2,21,1,0,1,1,2,2,1,0,
1,1,1,1,21,1,1,1,1,1,0,
1,1,1,17,17,17,17,17,21,1,1,
1,1,1,1,1,0,1,1,1,1,1,
1,1,0,1,21,1,1,1,0,1,0,
1,2,0,2,0,2,21,0,0,2,0,
1,1,1,1,21,1,1,1,0,1,0,
21,1,1,1,1,1,1,1,24,1,0,
0,1,1,1,0,1,1,1,0,1,21,
0,1,1,1,21,1,1,1,0,1,0,
0,1,1,1,0,1,1,1,0,1,21,
0,1,1,1,21,1,1,1,0,1,0,
0,0,0,0,0,0,0,0,0,0,0,
0,0,0,0,0,0,0,0,0,0,0,
0,0,0,0,0,0,0,0,0,0,0,
0,0,0,0,0,0,0,0,0,0,0.
[layer]
type=Tile Layer 2
data=
0,0,0,0,0,0,238,238,238,0,238,
111,111,111,55,111,0,111,111,111,111,111,
111,111,111,111,111,111,111,0,111,111,111,
121,121,121,121,121,0,121,121,121,121,121,
0,60,120,60,120,60,120,60,120,60,120,
255,255,127,0,255,0,255,0,0,0,255,
234,234,234,0,234,0,117,0,0,0,234,
189,189,189,0,189,0,189,189,189,189,189,
155,155,155,0,155,0,0,0,0,0,0,
201,100,100,0,201,201,100,201,201,0,201,
99,199,199,0,199,199,199,199,199,0,199,
58,58,116,0,58,116,116,58,116,116,116,
0,0,226,0,226,0,0,0,226,226,226,
0,106,53,106,53,106,106,106,53,106,106,
106,106,106,0,106,106,106,106,106,106,106,
0,0,0,0,162,162,162,0,0,0,162,
128,128,64,128,128,128,64,0,128,0,128,
0,0,0,0,80,160,80,0,160,0,160,
0,0,0,0,145,145,72,0,145,145,145,
50,101,50,101,101,0,101,101,101,50,101,
0,0,0,0,143,0,143,71,143,0,0,
124,124,62,0,62,124,124,124,124,0,124,
0,0,0,0,0,0,154,154,154,0,154,
107,107,53,107,0,107,107,107,53,107,107,
140,70,70,70,70,0,0,0,0,0,0,
98,98,98,98,98,0,98,98,98,98,98,
138,69,138,0,138,138,69,0,0,0,138,
149,74,149,0,149,0,149,0,0,0,149,
148,148,74,0,148,0,148,0,0,0,148,
177,177,177,0,177,0,177,177,177,177,177,
133,133,133,0,133,0,0,0,0,0,0,
106,106,106,0,106,53,53,106,106,0,106,
105,105,52,0,52,105,105,52,52,0,105,
101,101,101,0,101,101,101,101,101,101,101,
0,0,213,0,213,0,0,0,213,213,213,
0,0,140,0,140,0,0,0,140,140,140,
90,90,90,0,90,90,90,90,90,90,90,
0,0,0,0,190,190,190,0,0,0,190,
150,150,150,150,150,150,150,0,150,0,150,
0,0,0,0,136,136,136,0,136,0,136,
0,0,0,0,67,134,67,0,134,134,134,
94,94,94,94,94,94,94,94,94,94,0,
0,109,54,109,109,109,0,54,54,54,0,
97,97,97,48,97,97,0,48,48,97,0,
0,108,108,108,108,108,0,108,108,108,0,
91,91,91,91,91,91,0,91,91,91,91,
90,45,90,90,90,90,45,90,45,45,0,
0,0,0,0,0,63,127,127,127,63,0,
46,93,0,93,93,46,93,46,93,46,0,
103,103,0,103,0,103,103,103,103,103,0,
92,92,92,92,0,92,92,92,92,92,0,
73,73,73,36,36,36,36,36,0,73,73,
72,72,72,72,72,0,72,72,72,72,72,
102,102,0,102,0,102,102,102,0,102,0,
91,91,0,91,0,91,0,0,0,91,0,
81,81,81,81,0,81,81,81,0,81,0,
0,120,120,120,120,120,120,120,0,120,0,
0,88,88,88,0,88,88,88,0,88,0,
0,87,87,87,0,87,87,87,0,87,0,
0,86,86,86,0,86,86,86,0,86,0,
0,85,85,85,0,85,85,85,0,85,0,
0,0,0,0,0,0,0,0,0,0,0,
0,0,0,0,0,0,0,0,0,0,0,
0,0,0,0,0,0,0,0,0,0,0,
0,0,0,0,0,0,0,0,0,0,0.