[layer]
type=Tile Layer 1
data=
0,0,1,1,1,0,1,1,1,0,0,
0,0,1,1,1,0,1,1,1,0,0,
1,1,0,0,0,0,0,0,0,1,1,
1,1,0,0,22,0,22,0,0,1,1,
0,0,1,1,0,0,0,1,1,0,0,
0,0,1,1,1,1,1,1,1,0,0,
0,0,0,0,1,1,1,0,0,0,0,
0,0,0,0,1,1,1,0,0,0,0,
0,0,1,1,1,0,1,1,1,0,0,
0,0,1,1,0,23,0,1,1,0,0,
1,1,0,0,1,0,1,0,0,1,1,
1,1,0,21,1,1,1,21,0,1,1,
0,0,1,1,1,0,1,1,1,0,0,
0,0,1,1,1,0,1,1,1,0,0,
0,0,1,1,1,0,1,1,1,0,0,
0,0,0,0,1,1,1,0,0,0,0,
0,0,22,0,1,1,1,0,22,0,0,
0,0,0,0,0,0,0,0,0,0,0,
0,0,0,0,0,0,0,0,0,0,0,
0,0,0,0,0,0,0,0,0,0,0,
0,0,0,0,0,0,0,0,0,0,0.
[layer]
type=Tile Layer 2
data=
0,0,103,103,103,0,103,103,103,0,0,
0,0,112,112,112,0,112,112,112,0,0,
112,112,0,0,0,0,0,0,0,112,112,
112,112,0,0,0,0,0,0,0,112,112,
0,0,101,101,0,0,0,101,101,0,0,
0,0,101,101,101,101,101,101,101,0,0,
0,0,0,0,101,101,101,0,0,0,0,
0,0,0,0,93,93,93,0,0,0,0,
0,0,93,93,93,0,93,93,93,0,0,
0,0,93,93,0,0,0,93,93,0,0,
83,83,0,0,83,0,83,0,0,83,83,
83,83,0,0,83,83,83,0,0,83,83,
0,0,81,81,81,0,81,81,81,0,0,
0,0,81,81,81,0,81,81,81,0,0,
0,0,81,81,81,0,81,81,81,0,0,
0,0,0,0,81,81,81,0,0,0,0,
0,0,0,0,81,81,81,0,0,0,0,
0,0,0,0,0,0,0,0,0,0,0,
0,0,0,0,0,0,0,0,0,0,0,
0,0,0,0,0,0,0,0,0,0,0,
0,0,0,0,0,0,0,0,0,0,0.