[layer]
type=Tile Layer 1
data=
1,1,21,1,0,1,1,0,1,1,1,
1,1,0,1,0,1,1,0,1,1,21,
1,1,0,1,0,1,1,0,21,1,1,
21,1,0,1,0,1,1,0,1,1,1,
1,1,0,1,0,1,1,0,21,1,1,
21,2,7,2,2,2,2,2,2,2,2,
21,1,0,1,0,1,1,0,0,1,0,
0,0,0,0,0,0,0,0,0,0,0,
0,0,0,0,0,0,0,0,0,0,0,
0,0,0,0,0,0,0,0,0,0,0,
0,0,0,0,0,0,0,0,0,0,0.
[layer]
type=Tile Layer 2
data=
29,29,0,29,0,29,29,0,29,29,29,
32,32,0,32,0,32,32,0,32,32,0,
31,31,0,31,0,31,31,0,0,31,31,
0,31,0,31,0,31,31,0,31,31,31,
30,30,0,30,0,30,30,0,0,30,30,
0,36,0,36,36,36,36,36,36,36,36,
0,29,0,29,0,29,29,0,0,29,0,
0,0,0,0,0,0,0,0,0,0,0,
0,0,0,0,0,0,0,0,0,0,0,
0,0,0,0,0,0,0,0,0,0,0,
0,0,0,0,0,0,0,0,0,0,0.