[layer]
type=Tile Layer 1
data=
0,2,1,21,1,2,21,1,1,21,0,
7,1,1,21,1,1,21,1,1,21,0,
0,2,1,21,1,1,0,1,2,3,0,
7,1,1,0,1,1,0,1,1,1,0,
0,2,1,0,1,2,0,1,1,1,0,
0,2,1,0,1,1,0,2,1,1,0,
0,1,1,0,1,1,0,1,1,6,0,
0,1,1,0,1,1,0,1,1,0,0,
0,1,6,0,1,6,0,1,6,0,0,
0,0,0,0,0,0,0,0,0,0,0,
0,0,0,0,0,0,0,0,0,0,0,
0,0,0,0,0,0,0,0,0,0,0,
0,0,0,0,0,0,0,0,0,0,0.
[layer]
type=Tile Layer 2
data=
0,84,84,0,84,84,0,84,84,0,0,
0,121,121,0,121,121,0,121,121,0,0,
0,70,70,0,70,70,0,70,70,70,0,
0,105,105,0,105,105,0,105,105,105,0,
0,70,70,0,70,70,0,70,70,70,0,
0,70,70,0,70,70,0,70,70,70,0,
0,70,70,0,70,70,0,70,70,70,0,
0,70,70,0,70,70,0,70,70,0,0,
0,70,70,0,70,70,0,70,70,0,0,
0,0,0,0,0,0,0,0,0,0,0,
0,0,0,0,0,0,0,0,0,0,0,
0,0,0,0,0,0,0,0,0,0,0,
0,0,0,0,0,0,0,0,0,0,0.