[layer]
type=Tile Layer 1
data=
1,0,1,0,1,21,1,0,1,8,1,
1,24,2,0,1,21,1,0,2,0,1,
1,1,1,21,1,1,1,21,1,1,1,
2,0,1,21,0,0,0,21,2,0,1,
1,0,2,0,0,0,0,0,2,0,1,
0,0,1,0,1,21,1,0,1,0,0,
0,2,1,0,1,21,1,0,2,1,0,
0,1,0,1,1,21,1,1,0,1,0,
0,1,0,1,1,1,1,1,0,1,0,
0,0,0,0,0,0,0,0,0,0,0,
0,0,0,0,0,0,0,0,0,0,0,
0,0,0,0,0,0,0,0,0,0,0,
0,0,0,0,0,0,0,0,0,0,0.
[layer]
type=Tile Layer 2
data=
129,0,129,0,129,0,129,0,129,0,129,
127,0,127,0,127,0,127,0,127,0,127,
76,76,76,0,76,76,76,0,76,76,76,
74,0,74,0,0,0,0,0,74,0,74,
72,0,72,0,0,0,0,0,72,0,72,
0,0,72,0,72,0,72,0,72,0,0,
0,71,71,0,71,0,71,0,71,71,0,
0,70,0,70,70,0,70,70,0,70,0,
0,70,0,70,70,70,70,70,0,70,0,
0,0,0,0,0,0,0,0,0,0,0,
0,0,0,0,0,0,0,0,0,0,0,
0,0,0,0,0,0,0,0,0,0,0,
0,0,0,0,0,0,0,0,0,0,0.