[layer]
type=Tile Layer 1
data=
0,0,1,21,0,1,7,0,1,0,0,
0,0,1,21,8,17,0,0,1,0,0,
0,7,1,1,1,1,16,1,16,1,1,
0,0,1,0,0,1,21,0,1,0,0,
7,0,16,0,0,1,21,7,1,0,0,
0,21,1,1,1,1,1,1,1,1,1,
0,0,1,0,7,16,0,8,1,21,0,
0,0,1,0,0,17,0,0,1,21,0,
0,7,1,1,1,1,1,1,1,1,1,
0,0,1,0,0,1,21,0,1,0,0,
0,0,1,0,7,1,21,0,1,0,0,
0,21,1,17,1,1,17,1,1,1,1,
0,0,1,21,0,1,0,0,1,7,0,
0,8,1,21,0,1,0,0,1,0,0,
24,8,1,1,1,16,1,1,16,1,1,
0,0,1,21,0,1,0,0,1,0,0,
0,21,1,1,1,1,1,1,1,1,1,
0,0,0,0,0,0,0,0,0,0,0,
0,0,0,0,0,0,0,0,0,0,0,
0,0,0,0,0,0,0,0,0,0,0,
0,0,0,0,0,0,0,0,0,0,0.
[layer]
type=Tile Layer 2
data=
0,0,165,0,0,165,0,0,165,0,0,
0,0,177,0,0,88,0,0,177,0,0,
0,0,175,175,175,175,87,175,87,175,175,
0,0,117,0,0,117,0,0,117,0,0,
0,0,107,0,0,214,0,0,214,0,0,
0,0,106,106,106,106,106,106,106,106,106,
0,0,208,0,0,104,0,0,208,0,0,
0,0,95,0,0,47,0,0,95,0,0,
0,0,141,141,141,141,141,141,141,141,141,
0,0,94,0,0,94,0,0,94,0,0,
0,0,126,0,0,126,0,0,126,0,0,
0,0,83,41,83,83,41,83,83,83,83,
0,0,123,0,0,123,0,0,123,0,0,
0,0,121,0,0,121,0,0,121,0,0,
0,0,160,160,160,80,160,160,80,160,160,
0,0,80,0,0,80,0,0,80,0,0,
0,0,79,79,79,79,79,79,79,79,79,
0,0,0,0,0,0,0,0,0,0,0,
0,0,0,0,0,0,0,0,0,0,0,
0,0,0,0,0,0,0,0,0,0,0,
0,0,0,0,0,0,0,0,0,0,0.