[layer]
type=Tile Layer 1
data=
1,1,0,1,1,21,1,1,0,1,1,
1,1,0,1,1,21,1,1,0,1,1,
1,1,0,1,1,21,1,1,0,1,1,
1,1,0,1,1,21,1,1,0,1,1,
1,1,0,1,1,21,1,1,0,1,1,
1,1,0,1,1,21,1,1,0,1,1,
1,1,0,1,1,21,1,1,0,1,1,
1,1,0,1,1,21,1,1,0,1,1,
1,1,0,1,1,21,1,1,0,1,1,
0,0,0,0,0,0,0,0,0,0,0,
0,0,0,0,0,0,0,0,0,0,0,
0,0,0,0,0,0,0,0,0,0,0,
0,0,0,0,0,0,0,0,0,0,0.
[layer]
type=Tile Layer 2
data=
96,96,0,96,96,0,96,96,0,96,96,
95,95,0,95,95,0,95,95,0,95,95,
85,85,0,85,85,0,85,85,0,85,85,
84,84,0,84,84,0,84,84,0,84,84,
83,83,0,83,83,0,83,83,0,83,83,
82,82,0,82,82,0,82,82,0,82,82,
81,81,0,81,81,0,81,81,0,81,81,
80,80,0,80,80,0,80,80,0,80,80,
79,79,0,79,79,0,79,79,0,79,79,
0,0,0,0,0,0,0,0,0,0,0,
0,0,0,0,0,0,0,0,0,0,0,
0,0,0,0,0,0,0,0,0,0,0,
0,0,0,0,0,0,0,0,0,0,0.