[layer]
type=Tile Layer 1
data=
1,1,1,1,21,21,21,1,1,1,1,
1,1,1,1,21,21,21,1,1,1,1,
1,1,1,1,1,21,1,1,1,1,1,
0,1,1,1,1,21,1,1,1,1,0,
0,1,1,1,6,21,5,1,1,1,0,
0,1,1,1,0,0,0,1,1,1,0,
0,1,1,1,0,0,0,1,1,1,0,
0,5,1,6,0,0,0,5,1,6,0,
0,0,1,0,0,0,0,0,1,0,0,
0,0,0,0,0,0,0,0,0,0,0,
0,0,0,0,0,0,0,0,0,0,0,
0,0,0,0,0,0,0,0,0,0,0,
0,0,0,0,0,0,0,0,0,0,0.
[layer]
type=Tile Layer 2
data=
96,96,96,96,0,0,0,96,96,96,96,
93,93,93,93,0,0,0,93,93,93,93,
73,73,73,73,73,0,73,73,73,73,73,
0,80,80,80,80,0,80,80,80,80,0,
0,79,79,79,79,0,79,79,79,79,0,
0,79,79,79,0,0,0,79,79,79,0,
0,79,79,79,0,0,0,79,79,79,0,
0,79,79,79,0,0,0,79,79,79,0,
0,0,79,0,0,0,0,0,79,0,0,
0,0,0,0,0,0,0,0,0,0,0,
0,0,0,0,0,0,0,0,0,0,0,
0,0,0,0,0,0,0,0,0,0,0,
0,0,0,0,0,0,0,0,0,0,0.