[layer]
type=Tile Layer 1
data=
0,0,1,1,1,1,16,1,1,21,0,
0,1,0,1,0,0,0,1,21,1,0,
0,1,0,24,0,0,0,0,21,1,0,
0,17,0,1,0,0,0,1,21,1,0,
0,1,0,0,0,0,0,0,21,1,0,
24,1,1,1,1,1,1,1,1,1,0,
0,1,0,0,0,0,21,1,1,1,0,
0,1,0,0,0,21,1,1,1,17,0,
0,21,1,1,1,1,1,16,1,21,0,
8,21,1,1,1,1,1,1,1,21,0,
0,1,21,1,0,24,0,1,0,1,0,
0,1,21,0,0,0,0,0,0,1,0,
0,1,21,1,0,0,0,1,0,1,0,
0,1,21,0,0,0,0,0,0,17,0,
0,16,1,1,1,1,1,16,1,1,0,
0,1,21,0,0,0,0,1,1,17,0,
0,1,21,0,0,0,1,1,1,1,0,
0,0,0,0,0,0,0,0,0,0,0,
0,0,0,0,0,0,0,0,0,0,0,
0,0,0,0,0,0,0,0,0,0,0,
0,0,0,0,0,0,0,0,0,0,0.
[layer]
type=Tile Layer 2
data=
0,0,113,113,113,113,56,113,113,0,0,
0,122,0,122,0,0,0,122,0,122,0,
0,181,0,0,0,0,0,0,0,181,0,
0,59,0,119,0,0,0,119,0,119,0,
0,109,0,0,0,0,0,0,0,109,0,
0,162,162,162,162,162,162,162,162,162,0,
0,108,0,0,0,0,0,108,108,108,0,
0,98,0,0,0,0,98,98,98,49,0,
0,0,97,97,97,97,97,48,97,0,0,
0,0,142,142,142,142,142,142,142,0,0,
0,126,0,126,0,0,0,126,0,126,0,
0,83,0,0,0,0,0,0,0,83,0,
0,82,0,82,0,0,0,82,0,82,0,
0,81,0,0,0,0,0,0,0,40,0,
0,40,80,80,80,80,80,40,80,80,0,
0,80,0,0,0,0,0,80,80,40,0,
0,79,0,0,0,0,79,79,79,79,0,
0,0,0,0,0,0,0,0,0,0,0,
0,0,0,0,0,0,0,0,0,0,0,
0,0,0,0,0,0,0,0,0,0,0,
0,0,0,0,0,0,0,0,0,0,0.