[layer]
type=Tile Layer 1
data=
0,1,1,1,0,1,21,1,1,1,0,
0,1,1,1,0,1,21,1,1,1,0,
0,1,1,1,0,1,21,1,1,1,0,
0,1,1,21,0,0,0,0,1,1,0,
0,1,1,21,1,1,1,0,1,1,0,
0,1,1,21,0,0,0,0,1,1,0,
0,1,1,1,0,1,21,1,1,1,0,
0,1,1,1,0,1,21,1,1,1,0,
0,1,1,1,0,1,21,1,1,1,0,
0,0,0,0,0,0,0,0,0,0,0,
0,0,0,0,0,0,0,0,0,0,0,
0,0,0,0,0,0,0,0,0,0,0,
0,0,0,0,0,0,0,0,0,0,0.
[layer]
type=Tile Layer 2
data=
0,96,96,96,0,96,0,96,96,96,0,
0,95,95,95,0,95,0,95,95,95,0,
0,85,85,85,0,85,0,85,85,85,0,
0,84,84,0,0,0,0,0,84,84,0,
0,83,83,0,83,83,83,0,83,83,0,
0,82,82,0,0,0,0,0,82,82,0,
0,81,81,81,0,81,0,81,81,81,0,
0,80,80,80,0,80,0,80,80,80,0,
0,79,79,79,0,79,0,79,79,79,0,
0,0,0,0,0,0,0,0,0,0,0,
0,0,0,0,0,0,0,0,0,0,0,
0,0,0,0,0,0,0,0,0,0,0,
0,0,0,0,0,0,0,0,0,0,0.